Fecha publicación,Section ,referral,direct,Paid,organic,Unique viewed pages,Page,Text
10/06/2021,Research,461,118,28,26,633,¿Está limpia el agua de tu playa favorita?,"El 88,5% de las aguas de baño del país, fueron calificadas como en estado “excelente”, según los datos del 2020 del informe anual de la Agencia Europea de Medio Ambiente. Aún así, algunas playas de Cataluña no pasaron la prueba. Si bien los datos pueden sonar muy alentadores, en España aún quedan 18 zonas que no cumplen con las normativas europeas sobre la calidad del agua. De las cuales cuatro son playas y una de ellas está ubicada en Barcelona, en Sant Adrià.

Se acerca el verano, el calor, las ganas de ir a la playa y meterse en el agua es una de las actividades más populares de la temporada, pero alguna vez nos detenemos a pensar: ¿Cuál es la calidad del agua? ¿Y del suelo dónde nos acostamos a tomar el sol? Todos los años la Comisión Europea junto con la AEMA, califican el agua de las zonas de baño, no solo de las playas sino también de zonas de baño interiores. 

De acuerdo a este informe , en 2020 se han supervisado 22.276 zonas de baño. La evaluación muestra que casi el 83% de estas aguas cumplen el nivel de calidad más exigente de la UE. El Director Ejecutivo de la AEMA, Hans Bruyninckx, asegura que: “La calidad de las aguas de baño europeas sigue siendo alta tras cuatro décadas de medidas destinadas a prevenir y reducir la contaminación”. Calidad de las zonas de baño de España. Total 2.239
Cierra una playa por contaminación en Sant Adrià
Luego de analizar la contaminación en la capa superficial de la arena se determinó que existe un riesgo para la salud. El Ayuntamiento de Sant Adríà decidió hacer efectivo el cierre de la playa a partir de principios de Junio. 

Los problemas que trae la actividad industrial en la zona no son nuevos. Cerca de la costa, históricamente operaban numerosas industrias que atentan contra la calidad del suelo. Según EFE Verde, la playa continuará cerrada hasta que el Ayuntamiento cuente con los informes definitivos, “de forma preventiva y priorizando la protección de la salud de las personas”. 

Una vez más queda demostrado como las actividades del ser humano tienen un impacto negativo sobre el planeta. Si bien en el país los resultados del informe de la calidad del agua han mejorado con respecto al año anterior, aún quedan muchas zonas que deberán ser tratadas. 

La próxima vez al elegir una playa para pasar el día, ¿Se lo pensará dos veces? "
11/10/2021,Research,366,67,87,3,523,¿Existe relación entre contaminación y salud mental?,"Diversos estudios han encontrado una relación entre altos niveles de contaminación medioambiental y una salud mental deteriorada. Las grandes ciudades con altos registros de contaminación en su ambiente son aquellas que poseen una población más vulnerable a posibles trastornos psiquiátricos.

Concretamente, el último estudio ha sido realizado en Barcelona, el cual ha contado con la colaboración ciudadana de 300 habitantes de la capital catalana. El estudio impulsado por ISGlobal e Ideas for Change ha puesto de manifiesto cómo afectan los preocupantes registros de contaminación al rendimiento cognitivo de una persona.

Según informa el medio The National Geographic, los agentes contaminantes que causan el deterioro del cerebro son unas nanopartículas (concretamente las PM 2.5) tan dañinas para la estructura cerebral como las causantes de enfermedades como el Alzheimer.

La relación entre contaminación y salud mental se comprobó mediante las cantidades de inhalación de sustancias contaminantes
Se recopiló información de los participantes sobre hábitos y movilidad durante 160 días. Realizaron un test de capacidad de atención y velocidad de procesamiento y una serie de preguntas sobre el nivel de estrés, el estado de ánimo y la calidad del sueño a través de una app. En muchos casos también proporcionaron sus datos de movilidad (GPS) y se midieron las cantidades de NO2 inhaladas por cada persona a través de un sistema de tubos, que permitía saber la cantidad acumulada a lo largo de una semana. 

Los resultados mostraron que la ciudadanos se concentran menos los días en los que la contaminación atmosférica es más elevada. Además, aumenta el nivel de estrés en jornadas con mayores cuotas de contaminación. Por otro lado, los residentes de zonas alejadas de zonas de costa o montaña tienen una salud mental más deteriorada debido a la inhalación de sustancias perjudiciales encontradas en el aire de las ciudades.

Además, una excesiva inhalación de sustancias contaminantes ocasiona en los humanos un efecto inflamatorio sistémico y de estrés oxidativo cerebral. A su vez, desencadena enfermedades como diabetes, asma, ataques de pánico y fallos en el sistema nervioso. Los expertos advierten que esta situación afecta cada vez más a personas de corta edad.

Las ciudades contaminadas son ciudades que enferman
Un informe publicado por la revista The Lancet Planetary Health, afirma que una correcta gestión de la calidad del aire podría reducir hasta 51.000 muertes prematuras. Las mayores tasas de gases contaminantes de NO2 y PM 2.5 se encuentran en países como Francia, Italia o España.

Lo contrario sucede en países nórdicos como Islandia, Suecia o Finlandia. Estos países tienen establecidos en las políticas del país unos planes de actuación medioambiental y una población comprometida con ello. Además, países como Noruega ya cuentan con un plan de neutralidad climática para 2030. "
19/12/2019,Research,84,46,6,21,157,Bajar el CO2: el desafío climático,"El cambio climático es el mayor desafío de los tiempos actuales y, como lo demanda la gente en las calles, requiere de medidas urgentes. Producto de nuestro estilo de vida, el planeta se está degradando. Para combatirlo es necesaria una transformación profunda del modelo económico de producción. Se debe perseguir el desarrollo sostenible y tiene que estar en concordancia con la erradicación de la pobreza. 

La necesidad de reducir el calentamiento global
Como lo enfatizó el secretario general de la ONU en la antesala de la COP25, el planeta se encuentra en un punto sin retorno. Basándose en informes del IPCC, advirtió sobre los esfuerzos insuficientes de los países. A su vez, instó en la necesidad de que el calentamiento global no supere los 1.5 grados con respecto a los niveles preindustriales. 

El período de referencia 1850-1900 se utiliza para establecer una temperatura media global en superficie aproximada a los niveles preindustriales.

Los últimos seis años han sido los más calurosos de la historia desde que existen registros confiables, según datos de la Organización Meteorológica Mundial. Si esta tendencia continúa, los efectos climáticos ya existentes podrían ser todavía más catastróficos. Entre ellos están el aumento del nivel del mar, la pérdida de ecosistemas marinos y terrestres y los fenómenos meteorológicos extremos.

Es necesario que se tomen medidas urgentes y que las naciones adecuen sus marcos normativos al Acuerdo de París. Según los expertos, las decisiones que se tomen hoy pueden seriamente impactar las posibilidades de un futuro sostenible para todas las regiones del globo. 

Los efectos de las emisiones producidas por las actividades humanas 
Desde la época preindustrial, las concentraciones atmosféricas de gases de efecto invernadero (GEI) han registrado un aumento continuo como consecuencia de la actividad humana. Estos impiden que se pierda parte de la energía que emite la tierra al absorber el calor del Sol. En consecuencia, aumenta la temperatura del planeta y se pierden miles de ecosistemas.

En el último boletín de gases de efecto invernadero de la Organización Meteorológica Mundial, se expone que la concentración de CO2 en la atmósfera, principal gas de GEI, alcanzó en 2018 las 407,8 partes por millón (ppm). Implica casi un 47% más que el nivel preindustrial. 

Según el IPCC, para limitar los riesgos de un calentamiento global, es vital que las emisiones antropógenas netas globales de dióxido de carbono (CO2) disminuyan en 2030 alrededor de un 45%, respecto de los niveles de 2010. A su vez, es necesario que siguieran disminuyendo hasta alcanzar el «cero neto» hacia el año 2050.

Esto implica que cualquier emisión remanente debe ser compensada mediante el retiro del CO2 de la atmósfera, con tecnología que aún no está desarrollada a gran escala. Para alcanzar estas metas, se requieren transiciones profundas y urgentes en la tierra y en los sistemas urbanos, industrial, energético y de infraestructuras.

Medidas insuficientes para combatir el aumento del CO2
Luego de tres años del Acuerdo de París, las medidas adoptadas por los países firmantes parecen ser inadecuadas e insuficientes para enfrentar al cambio climático. Es decir, no hay señales de desaceleración de las concentraciones atmosféricas de GEI.

Así quedó demostrado en el informe presentado por el Proyecto Global de Carbono durante la COP25. Las emisiones de CO2 han aumentado 0,6 % en el 2019 a nivel mundial, respecto del año anterior. Esto se debe a que, si bien el consumo de carbón se ha reducido, se han incrementado el consumo del gas natural y el petróleo.

Reconciliar nuestra relación con la naturaleza
Para reducir la huella de carbono es imperativo que se comprometan todos los actores y sectores sociales a escala mundial. El cambio climático es un reto social, político, cultural y económico y no meramente ambiental. La transición ecológica solo es posible con un cambio en el modelo económico de producción. Se debe frenar el consumo desenfrenado que pone en riesgo la supervivencia de miles de especies y afecta mayormente a las zonas más vulnerables.

Lograrlo implica una nueva conceptualización de la relación que los seres humanos tenemos con la naturaleza. En ello, los saberes de las poblaciones indígenas y las comunidades locales tienen un rol central para pensar una productividad ecológica."
1/12/2020,Research,87,21,3,23,134,Conflicto regional por la gestión de los recursos hídricos,"Variadas proyecciones se han esbozado en los últimos meses respecto a los efectos globales que dejará la pandemia desatada por el Covid-19. Mientras se intenta dar respuesta a urgencias sanitarias, otros conflictos por el acceso igualitario a recursos elementales se mantienen o profundizan.

La construcción de la Gran Represa del Renacimiento de Etiopía (GERD) lleva una década de pugnas y suspensos en el norte de África. Arbitrado por la mediación regional e internacional, la obra pone en cuestión el “statu quo” del dominio preferente de Egipto sobre las aguas del Nilo. También, deja ver el impacto respecto al acceso a sus aguas y a la producción de energía. 

El contexto socioambiental de un proyecto colosal
Iniciada en 2011, la represa que se construye aguas arriba del Nilo está financiada totalmente por la propia Etiopía y se convertirá en la mayor central hidroeléctrica del continente. Para Etiopía, esta obra supone la modernización de su economía y la posibilidad de abastecer la demanda energética de su población e, incluso, exportar electricidad. Sin embargo, Egipto, cuyo suministro de agua dulce depende en un 90% del Nilo, la considera como una amenaza. Esto es por las probabilidades de que peligre el abastecimiento de recursos hídricos (al afectar el caudal) y la generación de energía en su propia represa en Aswan.

Sólo el 45% de los habitantes de Etiopía, según datos de la  ONU, tiene acceso a energía eléctrica. En cambio, Egipto está en condiciones de abastecer a la totalidad de su población, mientras que Sudán, el tercer país involucrado en el conflicto, al 60%. La aparente particularidad de este déficit debe leerse a la luz de un dato global: se calcula que en el mundo 1.300 millones de personas viven sin electricidad.

Naciones Unidas ha establecido el período 2014 – 2024 como la “Década de la energía sostenible para todos”, haciendo alusión al Objetivo de Desarrollo Sostenible número 7 (ODS7) y en consonancia con el Acuerdo de París. El ODS7 tiene como meta principal de aquí al 2030 garantizar el acceso universal a servicios energéticos asequibles, fiables y modernos. Más de la mitad del mundo no tiene llegada a servicios de saneamiento seguros. Según UNICEF-OMS, una de cada tres personas no tiene acceso a agua potable salubre. 

Entre los peligros medioambientales asociados a la construcción de la GERD, se destacan la retención de sedimentos de la represa que podría reducir la fertilidad de las tierras en la cuenca del bajo Nilo, el aumento de la erosión y que la recarga acuífera disminuya, lo que afectaría el abastecimiento de agua.

¿Quién domina El Nilo? Las raíces de un conflicto regional por su gestión transfronteriza
La Gran Represa del Renacimiento acarrea una grave disputa regional entre diversos países africanos y no constituye una novedad al respecto sino que nos exige remontarnos a la época colonial para entender sus raíces histórico-políticas. 

En el año 1929 se firmó un primer tratado por el reparto de las aguas del Nilo entre Egipto y Sudán, “representado” este último por Gran Bretaña. En dicho acuerdo, Sudán se comprometía a “no llevar a cabo ninguna actuación que pudiera modificar el caudal del río Nilo, su nivel o su calendario de crecidas” como menciona Ayeb en La hidropolítica de Egipto: el fracaso de una estrategia hidropolítica. Luego de su independencia, en el año 1956, logró imponer a Egipto una revisión del reparto concertado, produciéndose la firma de un nuevo tratado en 1959. 

Etiopía, por su parte, no había reconocido la validez del acuerdo de 1929, manteniendo la misma postura para el del año 1959, ya que no se veía contemplada su participación en ninguno de ellos.

Esta seguidilla de tensiones y desencuentros involucra también cierta hostilidad entre los siete países de cabecera del río (Etiopía, Uganda, Kenia, Tanzania, Ruanda, Burundi y Congo) con los de su curso medio y desembocadura (Sudán y Egipto).

En mayo de 2010 en la ciudad de Entebbe Uganda estos países, antes no incorporados a los tratados referidos al Nilo, firmaron un acuerdo sobre los usos del mismo. Esto trajo el rechazo de Egipto y Sudán, aduciendo que sus derechos sobre la cuenca se basan en los tratados de la época colonial. En aquel momento la noticia fue acompañada con el recuerdo de una cita atribuida al líder egipcio Anuar Al Sadat: el agua «es el único motivo que puede llevar a Egipto de nuevo a la guerra».

Exhortaciones e intervenciones para resolver las disputas en el tramo final de construcción 
A pesar de las asesorías técnicas internacionales y de la presencia de observadores de la Unión Africana, la Unión Europea y los Estados Unidos, en los últimos años, los puentes de diálogo se han roto. Sin embargo, ciertos puntos de acuerdo son necesarios para poder gestionar futuros riesgos como sequías o problemas de abastecimiento de energía en dichos países.

En el mes de octubre, el ministro de Asuntos Exteriores de la UE, Josep Borrell, se ha manifestado en apoyo a las negociaciones impulsadas por la Unión Africana advirtiendo que “ahora es el momento de llegar a un acuerdo sobre el llenado” de la represa. Por otro lado, en una reunión del Consejo de Seguridad de la ONU celebrada en junio, Egipto solicitó su imperiosa intervención, mientras que Etiopía sostuvo que no corresponde plantear la temática en ese espacio y que la represa llevará electricidad a más de 65 millones de personas.

La posición Estadounidense
Estados Unidos ya había interrumpido su ayuda económica a Etiopía. Donald Trump realizó declaraciones escabrosas referidas a que Egipto terminará destruyendo la represa si no se llega a un acuerdo. A pesar de los informes, reuniones, declaraciones y mediaciones, la obra avanza y la tensión se acrecienta. Algunos medios denuncian el intento de Etiopía de “reconfigurar la topografía política de la cuenca del Nilo”, otros denuncian el control hegemónico que Egipto ha realizado históricamente, lo cual demuestra las interpretaciones y complejidades que puede existir detrás de lo que parecería ser una simple construcción de una represa.

La última etapa de construcción, en agosto de este año, ha generado también movilización en la población, demostraciones públicas animadas por personalidades del gobierno etíope y campañas en redes como las caracterizadas por los hashtags #ItsMyDam, #EthiopiaNileRights y #GERD. A pesar de las marchas y contramarchas que se produjeron por la controversia regional e internacional, se espera que alcance su capacidad máxima de generación de energía para 2023.

Los conflictos socioambientales requieren salidas colectivas 
La cuestión del agua como recurso fundamental y la gestión de ríos y canales transfronterizos continúan siendo elementos estratégicos para los países, al igual que el control de regiones destinadas a la extracción de minerales y al turismo. 
¿Cómo equilibrar o conciliar intereses y necesidades sobre bienes que son comunes y esenciales para todos? En principio, cabe destacar la falta de un acuerdo regional de cooperación con respecto a los usos y derechos del río Nilo, lo cual no permite contar con un piso o estructura básica para hacer frente al conflicto actual. También debe tenerse en cuenta que las raíces históricas de la falta de acuerdo se remontan a la época colonial, momento en el cual la pugna por la soberanía de las naciones del Tercer Mundo, sus límites geográficos y sus sistemas de gobierno significaba cuantiosos esfuerzos por desenvolverse. 

Hoy en día, la necesidad de un cambio de paradigma frente a los recursos naturales está en debate, pero a la vez está siendo impulsada por una diversidad creciente de actores políticos que involucra acciones en red entre Estados, organismos multilaterales y entidades subnacionales. Desastres y catástrofes socio-naturales en todo el mundo han provocado iniciativas dedicadas al desarrollo sostenible y a la búsqueda de resiliencia de las comunidades, empoderando a los diversos actores protagonistas.

A su vez, el desarrollo sostenible tiene dificultades para hablar una lengua universal, ya que las capacidades económicas y las particularidades sociales y culturales de cada región o país deben contemplarse frente a la dificultosa tarea de dar respuestas de igual parangón. Conflictos como el que la Gran Represa de Etiopía trae a colación, demuestran que la integración regional basada en la cooperación y el entendimiento mutuo por anhelos comunes a recursos y derechos esenciales resulta fundamental. "
15/01/2020,Research,47,33,0,6,86,COP25: la incapacidad política delega responsabilidades,"Como nunca antes, el mundo es consciente de la imperiosa necesidad de proteger al planeta de los daños provocados por la actividad humana. Si bien las alertas de los expertos existen desde hace años, es novedosa la concientización masiva a nivel mundial. Fenómenos como la joven activista Greta Thunberg, han contribuido al inspirar a millones de personas de todo el globo a involucrarse en la lucha climática. Las demandas apuntan a modificar el modelo de producción y el consumo desenfrenado que pone en riesgo la supervivencia.

Necesidades políticas por sobre la emergencia climática
Dentro de este contexto de presión internacional, la COP25 tenía la ambiciosa meta de generar los acuerdos para la reducción de emisiones. Su lema “Tiempo de actuar” entra en contradicción con la inacción política. El documento final ha fracasado porque no logra consensuar respecto al artículo 6 del Acuerdo de París. El mismo regula internacionalmente de los mercados de carbono, donde los países y empresas compensen entre sí los gases de efecto invernadero que expulsan.

El texto manifiesta, aunque sin aclarar de qué forma, la urgente necesidad de que las nuevas Contribuciones Nacionales Determinadas de los países durante el 2020 aborden la brecha con las actuales. El objetivo se encuentra en evitar el aumento de la temperatura media global por encima de 1,5°C que está por encima de los niveles preindustriales. Aunque la urgencia lo amerita, esta Cumbre solo consiguió que 84 países (como Alemania, Francia y España) se comprometieran a presentar planes más drásticos contra las emisiones. Sin embargo, los mayores responsables de la contaminación como EEUU, China, India, Japón, Brasil y Arabia Saudí no han pronunciado interés en reducir sus niveles.

El rol de la naturaleza
Si bien la ciencia tuvo protagonismo, su actuación no se vió reflejada en los resultados mínimos conseguidos para enfrentar la presente gravedad de la crisis climática. Entre los informes se destacó que el año que finaliza será récord en temperaturas y que las emisiones de dióxido de carbono, según el Proyecto Global de Carbono, han aumentado 0,6% respecto al 2018.

La COP25 promueve el desarrollo sostenible, como un modelo basado en la armonía de tres factores: el económico, el social y el medioambiental. Sin embargo, no ha habido avances significativos respeto a los derechos humanos y la financiación frente a los impactos climáticos en zonas vulnerables. El informe presentado por WWF establece que las Soluciones basadas en la Naturaleza (SbN) son esenciales para abordar la mitigación del calentamiento del planeta y la pérdida de la biodiversidad.

El protagonismo de los cuidadanos para enfrentar al cambio climático
La ciudadanía mundial está exigiendo cada vez con mayor fuerza que se actúe en consecuencia con la gravedad de la crisis climática y ecológica. Paralelamente a la COP25, se organizó en Santiago de Chile “La Cumbre de los Pueblos”. Bajo el lema «Salvemos la tierra, cambiemos el sistema», se reunieron organizaciones sociales de todo el mundo y discutieron las estrategias para enfrentar la mercantilización de la naturaleza que impone el modelo neoliberal y extractivista. En su declaración final rechazaron lo que calificaron como falsas soluciones de Madrid y demandaron evitar la “captura corporativa de las negociaciones”.

Esos días de intensos debates han reflejado que es vital que las personas y su futuro se encuentren en el centro de las respuestas a la emergencia climática. Además, se puso énfasis en que los temas ambientales deben estar presentes en la agenda política global. Afrontar estos desafíos implica avanzar hacia una transición justa y sustentable para todos basado en nuevas formas de entendimiento e intercambio entre los pueblos y la naturaleza.

Hitos de la COP25
121 países, 15 gobiernos subnacionales, 398 ciudades y 786 empresas se comprometieron a ser carbono neutrales hacia el 2050 en la “Alianza de Ambición Climática”.
El “Plan de Acción de Género” para combatir el efecto desigual del cambio climático en las mujeres fue aprobado.
Se creó el “Plan de Acción de Santiago” con los Ministros de Finanzas de 51 países para que sus políticas sean concordantes con un reducción de emisiones."
19/10/2021,Research,209,38,30,6,283,España en alerta por tsunamis,"Un estudio realizado por el Consejo Superior de Investigaciones Científicas (CSIC) pone en alerta real al sur de España ante posibles tsunamis. Esto se debe a un salto vertical en la falla Averroes de 5,4 metros en el extremo noroeste, lo cual le atribuye un enorme potencial para generar estos fenómenos devastadores. Su potencial ha sido analizado a partir de un estudio matemático de las masas de agua del Mar de Alborán.

La falla Averroes se sitúa entre Málaga y Marruecos. Las zonas en las que más podría afectar su actividad son la costa malagueña, la provincia de Almería y territorios marroquíes como el cabo Ras Tarf, Punta Negri y el nuevo puerto de Nador. 

España se encuentra en riesgo moderado de tsunamis
El estudio se ha publicado en la revista científica Scientific Reports y advierte de las catastróficas consecuencias que supondría esto para la península. El mismo Centro de Investigaciones avisa que la falla es capaz de producir movimientos sísmicos de hasta magnitud 7. Este hecho podría generar olas de hasta 6 metros, que llegarían al sur de la península en apenas 21 minutos.

El investigador del CSIC y experto en ciencias del mar, Ferrán Estrada, advierte que un fenómeno devastador de esta magnitud podría dejar al país inmerso en una profunda crisis medioambiental y económica y sufriría pérdidas de fauna marina e infraestructuras costeras.

Ante esta situación de alarma real, se pide al Gobierno Central trazar planes de actuación urgentes ante los pronósticos que se presentan. Aunque los investigadores consideran que no podría producirse de forma inmediata, alertan que esta situación es impredecible y se debe mitigar de manera preventiva cualquier situación que implique fenómenos devastadores.

La erupción del volcán en La Palma ha alarmado por la posible generación de tsunamis
La entrada en erupción del volcán Cumbre Vieja en la Isla de La Palma ha activado todas las alarmas. Expertos vulcanólogos advierten que podría ser otro factor a tener en cuenta en la producción de tsunamis.

Las Islas Canarias son otros de los territorios donde deberían extremarse las precauciones ante posibles mega-tsunamis. Estos fenómenos son propios de lugares volcánicos y pueden producir efectos en «cascada». Una ola producida por un mega-tsunami podría afectar a todas las islas. "
10/02/2020,Research,18846,7315,3,62,26226,La omnipresencia del plástico amenaza al planeta,"El plástico, al ser económico, versátil y confiable, ha inundado al planeta en los últimos años.
Esto tiene impactos nocivos tanto para el medio ambiente como para la salud humana. Según datos de la ONU, hoy se producen cerca de 300 millones de toneladas de basura plástica por día. Lo que es casi equivalente al peso de toda la población mundial.

El consumo masivo y rápido trae aparejadas gigantescas cantidades de desechos que nuestro planeta no puede digerir. El plástico persiste en el medio ambiente por siglos. ¿Cómo hemos llegado a esta situación? Su boom data de los años 50. Según los investigadores, su producción ha crecido más que cualquier otro material. Actualmente, en todo el mundo, se compran por minuto un millón de botellas de plástico.

El plástico está entre las fuentes más peligrosas del calentamiento global
La producción del plástico contribuye a las emisiones antropógenas globales de gases de efecto invernadero (GEI). Los gases emitidos forman un efecto de cobertura que atrapa el calor dentro de la atmósfera, causando un aumento de las temperaturas. El calentamiento global también es provocado por fenómenos naturales como las erupciones volcánicas y la rotación natural del sol, pero la amenaza significativa reside en las actividades humanas.

Las emisiones de GEI de la producción del plástico continúan aun cuando el material ya está desechado. Es más, cuando esta expuesto a la basura, es cuando emite más gases. Según expertos del CIEL, durante el año 2019, su producción e incineración agregaría a la atmósfera más de 850 millones de toneladas métricas de GEI. Si nada cambia, cada vez se está más lejos de llegar a los objetivos de emisiones de carbono.

Los efectos contaminantes de los desechos plásticos
El principal problema es que más de la mitad de la producción mundial del plástico está diseñada para ser usada por única vez. Su no durabilidad se agrava por el mal manejo de la gestión de los desechos, lo que provoca todavía mayores consecuencias contaminantes.

Según el último reporte de la ONU, solo el 9% de todos los desechos plásticos producidos han sido reciclados, alrededor del 12% ha sido incinerado, y el 79% se ha acumulado en basureros o en el medio ambiente. Una vez desechados, se descomponen en microplásticos que muchos animales ingieren y pueden terminar en la comida que consumimos los humanos. Esto afecta seriamente al ecosistema de los océanos, el pulmón del planeta.

Más del 75% de la producción mundial del plástico se desperdicia, según datos de WWF. La industria del reciclaje no es rentable debido a los altos costos de recolección y separación. Solo el 20% de los residuos plásticos se recolectan para reciclar.

La crisis del plástico desafía al mundo natural y a la sociedad global
La omnipresencia del plástico a escala global amenaza seriamente las condiciones de vida del planeta. El material, al tener características cercanas a la indestructibilidad, nos obliga a convivir con él por siglos.

Se debe instar a los gobiernos y a las empresas a que se inserten en la economía circular, donde el reciclaje y la reducción de la producción del plástico sean los principales motores. Los consumidores deben tener más opciones ecológicas alternativas al plástico.

La única esperanza para poder alcanzar los objetivos del Acuerdo de París y lo discutido en la COP25, es cambiar radicalmente nuestra forma de consumo. La forma de producción actual, para sostener la demanda del plástico, está destruyendo al mundo en el que vivimos."
19/03/2021,Research,810,281,18,21,1130,"Libre de Aceite de Palma: sus usos, controversias e impactos","Las fuertes y aceleradas inversiones en las economías como respuesta a la crisis económica del coronavirus, es el mayor temor de los grupos ambientalistas. 

Con apenas un par de meses de confinamiento, cierre de fábricas y bloqueo de actividades, los niveles de contaminación atmosférica han reducido notablemente. Pero es sabido que esto es puramente temporal. Lo que sucederá después de la crisis, cuando todo regrese a la “normalidad” depende de las medidas que tomen los estados de cara a la recuperación económica. 

Tras los reclamos de los expertos sobre los temores de que los planes de rescate económicos sean tomados de forma acelerada, los líderes de la Unión Europea acordaron prestar atención al objetivo de combatir el cambio climático. Muchos políticos, economistas y activistas dicen que las medidas deberían usarse para acelerar el cambio del carbón, el petróleo y el gas que calientan el planeta.

Una coalición global de más de 300 grupos de campaña de cambio climático instó a los gobiernos el jueves a usar cualquier paquete de rescate económico de coronavirus para ayudar a acelerar la transición hacia un futuro bajo en carbono.

Acordaron una “transición verde”, esa es la frase que utilizan para describir el objetivo de reducir las emisiones. Los detalles del plan quedan aún pendientes. 

La comisión ejecutiva de la UE llama a sus miembros a celebrar una cumbre en junio para planificar la neutralización de todo el bloque de gases de efecto invernadero. El detalle se halla en la fecha estimada: 2050. 

Los planes en diferentes países
Los inversores y los grupos ambientalistas buscan garantías de que, a medida que las consecuencias económicas del coronavirus absorben fondos y energía política, Bruselas no perderá de vista sus objetivos de cambio climático.

Polonia ha advertido que la pandemia hará que los objetivos climáticos de la UE sean más difíciles de alcanzar.

«Las decisiones que se toman en este momento darán forma a nuestra sociedad durante años, si no en las próximas décadas», dijo en un comunicado May Boeve, director ejecutivo de 350.org, un grupo de campaña climática global que se originó en los campus universitarios de EE. UU."
28/04/2021,Research,743,191,15,21,970,Llegó a España el primer camión eléctrico para reparto urbano,"Aquaservice se convierte en pionera en incorporar el FUSO eCanter eléctrico, de Daimler (Mercedez-Benz), para su trabajo de distribución por el país. El reparto comenzará en Valencia y se espera que en los próximos años se incorporen más camiones totalmente eléctricos en todo el territorio nacional.

Como explican en su sitio web, actualmente la empresa apuesta por una fuerte electrificación de la flota para añadir más vehículos ecológicos o híbridos que no utilicen diésel. Este modelo de transporte sostenible se suma a 110 camiones híbridos de reparto que ya se encuentran en funcionamiento.

¿Cómo funciona este vehículo sustentable?

El novedoso camión pesa 7,5 toneladas. Tiene 3,4 metros de distancia entre ejes y una longitud de 6,24 metros. Consta de seis baterías, las cuales están refrigeradas por líquido que le dan una autonomía de 100 kilómetros en condiciones reales. ¿Cómo y en cuánto tiempo se carga? Si se conecta a un cargador rápido de corriente continua, la batería estará llena en una hora y media.  

Este tipo de vehículos ya circulan en 12 mercados europeos, y no serán los únicos en España. Próximamente en Madrid se espera que la empresa alemana, DB Schenker, brinde cuatro camiones eCanter como parte de un programa a nivel europeo que tendrá un total de 36 nuevos FUSO eCanter en once países. 

Por el momento el territorio nacional no cuenta con una infraestructura de recarga para la movilidad eléctrica. Según Híbridos y eléctricos, la compañía energética Repsol, tiene previsto instalar 1000 estaciones de carga cada 50 km por todo el país. Suministrando así electricidad de origen 100% renovable. 

La gran mayoría de la energía eléctrica en España se genera de dos formas: quemando algún combustible o mediante reacciones nucleares. Apenas un 20% proviene de energías renovables como la eólica o la solar.

La REE, red eléctrica de España, espera que para el 2030, un 42% de la energía final sea renovable. Este plan persigue los objetivos planteados en el borrador del Plan Nacional Integrado de Energía y Clima 2021-2030 (PNIEC 2021-2030).
Al fin y al cabo, para que el cambio sea real, la energía utilizada para hacer funcionar estos vehículos eléctricos debe ser sustentable. Sino será mover el foco del problema pero no erradicarlo de raíz.

Entonces, ¿Cuál es el fin de elegir el FUSO eCanter eléctrico?

Reducir la huella de carbono. Avanzar hacia la descarbonización y ser carbono neutral antes del 2030, para conseguir que las ciudades sean espacios más sostenibles. Los altos niveles de contaminación atmosférica por consecuencia de las emisiones de CO2 están provocando efectos negativos en nuestro planeta, por ejemplo, en el aire que respiramos.

La compañía viene apostando por el cambio a lo sustentable, comenzando desde cero, con la reutilización de bidones de agua para evitar la generación de residuos. Alberto Gutierrez, CEO de Aquaservice, expresó en el Valenciaplaza que: “Aquaservice es una empresa nativa en economía circular, aspecto del que no éramos conscientes. Por eso no nos vale con integrar la economía circular, que ya lo hacemos, y queremos ir más allá. Así, en 2021 vamos a ser una compañía residuo cero y neutra en carbono, también en reparto al cliente final”.

El desafío estará en que las empresas energéticas, encargadas de suministrar la electricidad reduzcan la que generan quemando carbón. Que este sea en su totalidad renovable, y que pasar a los vehículos eléctricos signifique un impacto verdadero y positivo. "
21/09/2021,Research,354,43,58,12,467,Llueve en Groenlandia en su punto más alto,"El pasado 14 de agosto se registró lluvia en Groenlandia, según reportaron desde el Centro de Datos de Nieve y Hielo de Estados Unidos (NSIDC); región dónde no llovía hace más de 70 años. Los científicos se muestran preocupados y aseguran que es una prueba más del “inevitable” calentamiento global. 

Que llueva no es de asombro para la mayoría de las personas, pero no es normal que suceda en esta parte del hemisferio norte. Menos aún que lo haga en el punto más alto de Groenlandia, a 3.200 metros, dónde solo nieva. Esto ocurrió porque las temperaturas superaron en un promedio de 18ºC las habituales en la región.

Como consecuencia de la lluvia, se comenzó a derretir la nieve, afectando a 872.000 km cuadrados. Hasta el momento, no existe ningún informe previo de lluvia en esta ubicación localizada en la coordenadas geográficas 72.58 °N, 38.46 ° W a unos 3.216 metros de altitud, según National Geographic. La lluvia en Groenlandia fue causada por la alta presión de aire
Se produjo una alta presión al sureste de Groenlandia, que se combinó con un fuerte centro de baja presión al oeste de la región. Ambas fuerzas soplaron aire caliente y húmedo, lo cual aumentó las temperaturas y provocó que la nieve se transformara en lluvia, explicaron los expertos del Centro Nacional de Datos de Nieve y Hielo.

La creciente frecuencia de calentamiento y derretimiento en el Ártico es evidencia real del calentamiento climático en Groenlandia, explicó Thomas Mote, científico del clima, al The New York Times.

Si se derritiera todo el hielo de Groenlandia, el nivel del mar aumentaría unos 6 metros
Actualmente la masa de hielo de la isla se está fundiendo más rápido que en los últimos 12.000 años. El nivel del mar ya está aumentando. Para fines de siglo crecerá hasta 100 cm más, según el último informe del IPCC (Panel Intergubernamental sobre Cambio Climático). Esto terminaría obligando a más de 200 millones de personas a desplazarse. 

Las actividades humanas provocan emisiones de carbono que están calentando nuestro planeta. Un mayor calentamiento incrementará el deshielo del permafrost, así como la pérdida de la capa de nieve estacional, el derretimiento de los glaciares y los mantos de hielo y la pérdida del hielo marino del Ártico en verano. 

Es necesario del compromiso de los principales gobiernos del mundo para evitar que estos cambios se vuelvan irreversibles. Reducir las emisiones de gases de efecto invernadero debería ser una de las prioridades en la agenda gubernamental mundial.
"
8/02/2021,Research,229,70,18,317,634,Los 5 países más contaminantes del mundo,"La actividad humana es una de las principales causas del cambio climático, en concreto las emisiones de gases efecto invernadero que se produce con ellas. Desde la Unión Europea, ya se ha querido revertir esta tendencia al alza con su Agenda 2030, la que se espera que los gases contaminantes se reduzcan un 7,6% cada año entre 2020 y 2030.

Global Carbon Project mide la emisión de los gases efecto invernadero, entre ellos el dióxido de carbono, el metano y el óxido nitroso. ¿Cuáles son los países más contaminantes del mundo? Según su último informe de 2019, estos son los que producen más emisiones de gases de efecto invernadero.


Co2 Territorial emissions in 2019
CHINA

China es el país que más contamina el aire del planeta, en mayor parte con el CO2 que origina su industria. Tan solo en 2019, el país emitió 10.175 millones de toneladas de CO2. Antes de normalizar el uso de la mascarilla por el Covid19, ya era habitual encontrarlas entre la población del país asiático, quienes las utilizaban para poder filtrar el aire que respiraban y evitar las partículas contaminantes. Aunque el pasado 2017 puso en marcha su plan para “reciclar” las emisiones de su industria, de momento, lo único que ha ayudado a disminuir las mismas ha sido el confinamiento que ha llevado a una disminución de hasta el 40% de NO2 y ozono. Sin embargo, el centro de investigación CREA, avisaba de su vuelta a los valores de contaminación anteriores.

ESTADOS UNIDOS

Estados Unidos contribuyó con un total de 5.285 millones de toneladas de CO2, a lo largo de 2019. A diferencia de otros países, Estados Unidos no tiene planes – al menos de conocimiento público- para mejorar sus datos. Incluso, los acuerdos de mejoras para el medio ambiente no fueron bien recibidos por parte del expresidente del país, Donald Trump. Ahora, la política ecológica queda en manos de Joe Biden. San Francisco y Los Ángeles son algunas de las ciudades más afectadas. Según la Agencia Efe Verde “la inhalación de ozono perjudica los pulmones y puede provocar problemas respiratorios, ataques de tos y de asma”.

INDIA

India podría ser, próximamente, una de las potencias mundiales. Aun así, no ha podido controlar los altos índices de gases contaminantes, en concreto, emiten 2.616 millones de toneladas de CO2 al año. Este es otro de los países donde es habitual ver a sus habitantes usar mascarillas durante los períodos de más contaminación en el aire, para poder respirar sin riesgo de padecer problemas respiratorios. Además, no solo preocupa su contaminación aérea, sino que poseen el río Ganges que es actualmente el más contaminado del mundo. Sobre él se extiende una capa de basura y suciedad que en algunas zonas llega hasta ocultar el agua.

RUSIA

Los niveles de gases contaminantes en Rusia llegaron a 1.678 millones de toneladas de CO2 el 2019. Gran parte de los gases provienen de vertidos petroleros en la región de Komi, un fenómeno que, según Greenpeace, produce vertidos en las aguas y recursos naturales pero también contaminación en el aire. La unión de estas de ello ha supuesto un aumento de gases invernadero en la región. Sin embargo, este 2021 se ha propuesto mejorar sus políticas ecológicas. Es por eso que “Putin ha ordenado al Gobierno que desarrolle una estrategia de desarrollo social y económico que garantice para 2030 la reducción del 70% de las emisiones con respecto a 1990”, según la agencia EfeVerde.

JAPÓN

Japón produce gran cantidad de gases contaminantes, en 2019 produjo un total de 1.107 millones de toneladas de CO2. La paradoja en éste país reside en que aún siendo uno de los países más contaminantes a nivel mundial, también es uno de los países con más políticas ecológicas para mitigar estas emisiones. Esta urgencia se debe a los últimos fenómenos meteorológicos sufridos, como es el caso del tifón Jebi en la región de Kansai o a los 41,1ºC en la ciudad de Kumagaya que produjo 65 muertes el pasado 2018, según Efe.

Hasta el momento, no se han visto las mejoras en las políticas europeas. El parón de actividad producido por la pandemia de Covid-19 ha registrado la mayor caída en la emisión de CO2 que se ha registrado en la historia, según la BBC. Pero esto no es más que una consecuencia al azar y no una mejora buscada. Tanto es así que los niveles de CO2 han vuelto a aumentar desde la vuelta a la “nueva normalidad”."
19/01/2021,Research,572,196,21,71,860,Los libros digitales no son tan ecológicos como creemos,"Los libros electrónicos son, para la mayoría de las personas, una alternativa ecológica frente a los libros convencionales; sin embargo, cuando investigamos más a fondo el tema, comienzan los interrogantes y entramos en un interesante debate que merece nuestra atención.

El principal impacto de un libro tradicional está en la producción del papel, y el del e-book, en la fabricación del dispositivo, ya que para crear un e-reader se necesitan metales como el aluminio, el cobre o el litio y minerales como el coltán.

La segunda comparación tiene que ver con las emisiones de CO2, que para un libro en papel rondan los 21 kg y para un e-reader rondan los 2690 kg de CO2 durante toda su vida útil. Los libros en papel son considerados bienes de larga duración y no consumen ningún tipo de energía durante su uso. Sin embargo, debemos tener en cuenta que en un lector de libros electrónicos podemos almacenar miles de libros y cuando está cargado no consume electricidad; el mayor impacto procede de su proceso de fabricación. Mientras tanto, los bosques producen oxígeno natural para contrarrestar las emisiones de CO2 generadas por aparatos electrónicos como ordenadores, tablets y e-readers. Pero sin dudas lo novedoso de estos últimos es que poseen la famosa tinta electrónica, que tiene un consumo de energía muy bajo y por eso tienen mucha autonomía: pueden cargarse cada 15 o 20 días. También, por medio de la iluminación indirecta, nos permiten leer en cualquier sitio, en la oscuridad o en la playa. Es decir, podemos leer, aunque el sol nos pegue de frente, a diferencia de las pantallas convencionales, con las que sería muy molesto y casi imposible. Además, las pantallas convencionales, al ser retroiluminadas, traen fatiga visual. En cambio, leer en un lector digital no nos hace mal a la vista, ya que es como leer un libro físico. Pero lo más notorio de las pantallas convencionales es que gastan mucha batería. De esto último nos damos cuenta cuando, por ejemplo, leemos en el móvil.

El avance tecnológico y el confinamiento por la COVID-19 hicieron que los libros electrónicos cobren más relevancia y sus ventas aumenten de manera significativa.
Sobre los e-books

Podemos leer libros electrónicos o e-books en un ordenador, en una tableta, en un móvil o en cualquier lector de libros electrónicos (e-readers como el Kindle, por ejemplo). Con respecto a los formatos, el más común es el .epub, pero también existen formatos nativos como el .mobi de Amazon. Lo novedoso es que Adobe PDF ahora permite que los PDFs se adapten, que sean responsive. Pero esa es otra historia…

Para visualizar un e-book, necesitamos una aplicación o programa como el Adobe Digital Editions. También existen otras aplicaciones como Google Play Books, Bookari y Bookmate, entre muchas más. Para móviles, ipads o e-readers, la App Kindle es por lejos la mejor: nuestros libros se sincronizan automáticamente en todos nuestros dispositivos y podemos personalizar nuestra experiencia de lectura: podemos modificar el tamaño y el tipo de letra. Otro de sus beneficios es que nos indica cuántas páginas nos quedan por leer y cuánto tardaríamos en leerlas teniendo en cuenta nuestro ritmo de lectura. También podemos seleccionar una palabra y podemos saber qué significa. Esto es útil cuando leemos en otro idioma, ya que el Kindle está vinculado a un diccionario, a un traductor y a Wikipedia. Hacemos click sobre la palabra y podemos ver el significado, la traducción o, si es una persona histórica, ver su entrada en Wikipedia.

Con respecto a las ventajas de los libros electrónicos, encontramos la practicidad: podemos llevarlos a todos lados; la comodidad: no debemos cargar con el peso del libro físico; y la portabilidad: podemos almacenar decenas de libros en unos pocos bytes. No nos olvidemos de la disponibilidad inmediata de los e-books, ya que están siempre a nuestro alcance, nunca se agotan.

¿Qué tan ecológico es el papel de un libro?

Al publicar libros impresos, las editoriales españolas que buscan brindar una imagen de compromiso con la ecología colocan en sus páginas el emblema con la certificación forestal que brindan los sellos FSC (Forest Stewardship Council) y de la PEFC (Asociación para la Certificación Española Forestal). Sin embargo, hace algunos años que Greenpeace y otras organizaciones ecologistas cuestionan el cumplimiento de las normas establecidas por esas organizaciones. Greenpeace, por su parte, ha llevado a cabo varios estudios sobre este tema.

La editorial española Errata Naturae aprovechó el confinamiento para frenar y reflexionar sobre qué rumbo tomar y sus decisiones tienen la intención de aumentar la necesaria concienciación de cara a la defensa de los ecosistemas y la lucha contra el cambio climático. Han comenzado un proceso de transformación muy interesante. Sus prácticas son un ejemplo de que es posible una vida más libre y ecológica: han desestimado por poco fiables a los sellos FSC o PEFC y van a diseñar los libros de modo que sean 100 % reciclables, utilizando algunos de los papeles más ecológicos del mundo.

Sobre la deforestación

El reciente informe “Frentes de Deforestación”, llevado a cabo por WWF España, analiza las soluciones a la deforestación y concluye que estas deben ser integrales y adaptadas al contexto y deja en claro que no hay una única solución, sino que se deben combinar múltiples variables.

Así como existen aplicaciones que, al escanear un producto, podemos saber qué es lo que estamos consumiendo (por ejemplo: Yuka, que al escanear productos alimentarios y cosméticos podemos descifrar su composición y evaluar los efectos sobre nuestra salud). Qué bueno sería que exista una aplicación que nos diga si la elaboración de un producto ha contribuido a la deforestación o no. Varias organizaciones ecologistas se unieron a la campaña de WWF “No te comas el bosque (#Together4Forests)”, donde más de un millón de personas han pedido una nueva ley de la UE para garantizar que la producción de este tipo de objetos se haya hecho sin afectar la deforestación y la destrucción de la naturaleza.

En la actualidad existen muchos estudios exhaustivos sobre este tema y es difícil adoptar una postura. Lo ideal sería que hagamos un consumo responsable tanto del papel como del uso de los dispositivos electrónicos. Es importante que seamos conscientes de los bienes que consumimos, que nos preguntemos de dónde vienen y que reflexionemos con el fin de adoptar buenas prácticas."
13/03/2020,Research,126,85,6,6,223,Riego fotovoltaico: la clave para una agricultura más sostenible,"Método 100% renovable, que no consume electricidad (convencional) y ahorra agua. ¿De qué se trata?

Un sistema de riego fotovoltaico consiste en una bomba que es alimentada por energía solar. Se utilizan paneles solares que transforman la energía luminosa del sol en energía eléctrica, la cual alimenta las bombas que toman el agua de pozos subterráneos, que luego es utilizada para el riego. De esta manera, no sólo se ahorra dinero y se disminuye el consumo de restos fósiles, también produce menos contaminación atmosférica.

Investigadores de la Universidad Politécnica de Madrid (UPM) y otros centros europeos han creado el riego fotovoltaico; un método 100% renovable para la irrigación agrícola basada en sistemas de bombeo fotovoltaico. No consume electricidad convencional, ahorra un 30% de agua y un costo energético entre el 60 % y 80%, logrando hacer del riego una actividad limpia, más eficiente y económica.

Este proyecto se llevó a cabo en el marco del proyecto europeo MASLOWATEN liderado por la UPM.

El objetivo fue generar un sistema para satisfacer las necesidades de los regantes y su integración al sistema preexistente mediante un diseño innovador que permitiera el máximo aprovechamiento fotovoltaico. El desafío al cual se enfrentaron los especialistas fue suprimir la intermitencia de la potencia fotovoltaica que ocurría sin el uso de baterías.

Las soluciones implementadas tuvieron una gran aceptación social. Quienes lo implementaron, utilizaron energía 100% renovable y redujeron el consumo de agua entre el 25% y 34%. También, fue un logro desde el punto de vista ambiental puesto que el tiempo necesario para recuperar la energía invertida es de entre 1,9 y 5,2 años, y el período de retorno del dióxido de carbono es de entre 1,8 y 9,3 años.

Son tres las patentes que protegen esta innovación y se aplicaron a cinco demostradores a escala real en España, Portugal, Italia y Marruecos bajo condiciones reales de operación.  De esta manera, son 22 las PYMES licenciadas interesadas en diseñar e instalar este tipo de sistemas.

Una agricultura más sostenible, desde el punto de vista económico y ambiental, es posible en el sur de Europa si se introduce y propaga este tipo de sistemas.

Un investigador sostiene que el método “permitiría ahorrar 20.000 millones de m3 de agua para riego al año, 16 millones de toneladas anuales de emisiones de CO2 y la creación de más de 290.000 puestos de trabajo”.
La investigación y desarrollo del proyecto fueron posibles gracias a los fondos recibidos por el programa de la Unión Europea Horizonte 2020 la cual se dedica a financiar proyectos para la investigación e innovación de diversas áreas."
13/02/2020,Lifestyle,115,29,0,12,156,¿Cómo analizar un diamante?,"¿Has oído hablar de las 4 C´S? Sergio Murcia, CEO y fundador de Mimoke ethical jewelry, nos cuenta cómo analizar un diamante.

La joyería siempre tuvo esa cuota de misticismo y frialdad que viene dada por ser un producto exclusivo y por lo que genera en el cliente la experiencia de compra. “Todos sabemos un poquito de coches, de textil, de alimentos, pero casi nadie sabe de joyería; es un sector no muy dado a dar explicaciones” cuenta Sergio.

Mimoke es una marca de alta joyería ética que cuida a la naturaleza y a las personas. Comercializan piezas de joyería con diamantes creados de laboratorio para anillos de compromiso, alianzas, pendientes, pulseras y colgantes. Parte de su compromiso reside mostrar una nueva cara de este sector y convertirlo en una experiencia adaptada a las nuevas generaciones de consumidores. Los clientes quieren saber más y Mimoke se encarga de: “estar muy cerca de los clientes, tener todas las líneas abiertas y explicar cómo se hacen las cosas”, cuenta su fundador.

A continuación, las cuatro claves para saber diferenciar un diamante;

Talla (Cut)

Hace referencia a la forma del diamante en sí. La forma redonda (brillante) es la más común y esto se debe a que es la que mejor se refleja la luz del diamante.

Peso (Carats)

Son los kilates. Habla de cuánto pesa la pieza.

Color (Colour)

Se analiza cuánto se separa del blanco absoluto. Los colores oscilan entre los diamantes incoloros a tonalidades de amarillos o marrones, aunque también pueden ser azules, verdes, rojos…etc. Los mejor considerados por su rareza se encuentran en los extremos, por lo que un diamante es totalmente blanco o de un color intenso (fancy), tiene un alto valor.

Pureza (Clarity)

Nos permite analizar cuantas imperfecciones tiene el diamante. Lo cierto es que todas las diamantes tienen en su interior alguna imperfección, no existen los diamantes puros.

“Los diamantes naturales y de laboratorio son exactamente iguales. Ópticamente no existe ninguna diferencia”, asegura Sergio y añade: “hay quienes quieren comprar una pieza con un diamante natural que es único, y que sí que es verdad que fue creada durante millones de años y eso tiene un valor, pero hay gente que no lo compra”. Esto es, porque deciden proteger al planeta y a las personas que trabajan para crear estas piezas.

Hablamos comúnmente de diamantes “naturales”, pero, ¿Debemos seguir apoyando de manera “natural” diamantes que perjudican a la tierra, apoyan puestos de trabajo de dudoso gusto y que están controlados por un monopolio? Tal vez, podamos reflexionar en que lo más natural sería apoyar por un diamante que evita esta situación y que además resulta mucho más asequible."
16/12/2019,Lifestyle,81,26,3,15,125,¿Cómo cuidas el planeta? Apps ecofriendly,"A medida que el mundo va tomando conciencia sobre la necesidad que tenemos de mejorarlo entre todos, nuevas aplicaciones aparecen para confirmarnos que cada aporte, importa. Too Good To go

Para evitar el desperdicio de alimentos.

Cada año se tiran a la basura más de 1.300 millones de toneladas de comida en el mundo. Esta app te permitirá contribuir en salvar las sobras de restaurantes, supermercados, panaderías y más establecimientos a un precio reducido que por lo general oscila entre los 2 y 5 euros.

#lacomidanosetira Plantix

Para cuidar uno de nuestros bienes más preciados.

Funciona como un médico móvil para tus plantas. Solo debemos tomarle una foto, y la aplicación nos brindará información sobre qué tipo de planta es, si está afectada con alguna enfermedad y cómo solucionarlo. Making

Para aquellos diseñadores y marcas que busquen producir de manera sostenible.

Fue creada por Nike para analizar el grado de toxicidad y nivel de impacto que tienen los tejidos utilizados en cada prenda. Es una aplicación para diseñadores y creadores para que puedan tomar mejores decisiones para el medio ambiente.

“Sabemos que cada decisión que un diseñador toma en la creación de un producto tiene un impacto en el medioambiente. Dado el rango de opciones que existen, tomar decisiones con información puede resultar un desafío, de ahí la importancia de making” afirma la empresa. Changers CO2 Fit

Para ejercitarse de la manera más sana.

Principalmente esta app nos permite contar nuestros pasos. El objetivo es que cada persona pueda colaborar en reducir la cantidad CO2 emitido y cuidar el medio ambiente. Es gratuita para el público en general y tiene otra versión para empresas que quieran ofrecer a sus empleados una plataforma de salud. Pueden. por ejemplo, elegir entre distintas actividades guiadas como ejercicios, meditación, revisiones médicas y más.

Además, la aplicación ofrece la posibilidad de plantar nuestros propios árboles o hacer donaciones a distintas organizaciones a medida que vamos destrabando desafíos y avanzando en distintas actividades propuestas."
27/04/2020,Lifestyle,1195,276,9,3,1483,¿Cómo desinfectar los alimentos en casa?,"¿Tenemos incorporado en nuestro día a día el habito de sanitizar frutas y verduras? Esta crisis sanitaria dejará huellas de todo tipo. Una de ellas, posiblemente sea una mayor consciencia higiénica. En los supermercados, la obligación de utilizar guantes para la compra de frutas y verduras fue una de las primeras medidas tomadas. Resulta tal vez extraño pensar que previo a esta pandemia no tuvieramos en cuenta estos cuidados.

La higiene de los alimentos es importante para poder lleva a nuestra mesa productos inocuos, libres de patógenos que nos puedan generar algún daño.

Aquí tenemos un paso a paso a seguir para realizar el procedimiento de desinfección de manera correcta:

1. Lava bien tus manos antes de manipular estos alimentos.

2. Coloca la fruta o verdura sin pelar debajo de la canilla por al menos 2 minutos.

3. Utiliza un cepillo que te ayude a remover la suciedad.

4. Elimina las hojas externas, ya que pueden tener contaminantes.

5. Coloca la fruta y la verdura en un recipiente limpio lleno de agua. Por cada litro de agua debes colocar 2 gotitas de lejía apta para alimentos. Asegúrate de leer bien las indicaciones de los rótulos ya que estos cambian.

6. Deja reposar las frutas y verduras por 10 minutos en este recipiente.

7. Enjuágalas.

8. Dejalas secar en un repasador limpio.

Productos específicos para desinfección de virus
Debemos centrarnos en aquellos productos que sirvan para eliminar el virus. Hay ciertos desinfectantes naturales como el bicarbonato de sodio el limón y él vinagre los cuales no  está comprobado que eliminen efectivamente los virus. Sí son efectivos para matar bacterias y otros patógenos.

La lavandina diluida y el alcohol al 70% son efectivos para desactivar el virus. Estos actúan mejor si se los mezcla con agua. Su función es desactivar la estructura del virus para que éste no pueda seguir operando.
¿Cómo preparar estos desinfectantes?
El alcohol al 70 se prepara con 7 de partes de alcohol y 3 de agua, en un recipiente o rociador.

En el caso de la lavandina, generalmente son 2 gotas por litro pero es necesario leer atentamente el rotulo para prepararla.  Es importante que la lavandina sea apta para alimentos. Debe decir apta para desinfectar agua.

Luego de su desinfección, debemos pasar los productos por abundante agua para evitar intoxicarnos."
19/12/2019,Lifestyle,130,84,0,32,246,¿Conseguiremos la nueva revolución textil?,"La tragedia de Bangladesh continúa dejando marca en la historia y con un amargo especial en la industria textil.
Fashion Revolution es un movimiento global sin fines de lucro con equipos en más de 100 países de todo el mundo. Realizan campañas para la reforma de la industria de la moda para la búsqueda de mayor transparencia en la cadena de suministro. 

Alejandra de Cabanyes, Co-coordinadora nacional Fashion Revolution España nos cuenta el estado actual de la industria textil.

¿Cómo surgió el movimiento #whomademyclothes y qué fue lo que descubrieron?

Más de mil personas murieron en la fábrica; en ese momento surgió la campaña. 
La necesidad de una mayor transparencia en la cadena de suministro y de que se terminen los abusos fueron los hitos de la campaña «Who made my clothes». La semana del 24 de abril celebramos la Fashion Revolution Week, en la que pedimos por estos cambios.

¿En qué países se encuentran más dificultades para producir de manera sostenible?

Los países en los que existen menos regulaciones.
Vivimos en un sistema en el que prima el rendimiento económico y las empresas tienden a ir al límite del marco legal de cada país. 
Tanto en cuanto regulen los entes estatales, tanto actúan las empresas. 
En Centro América, Sud América y Asia hay mucho abuso. Al final, siempre es un tema de regulación, si está o no regulada por ejemplo el uso del agua, entre otras cuestiones.

¿Cuáles son los materiales más comúnmente utilizados para fabricar ropa?

El 70% de los materiales son sintéticos (poliéster, nylon) 30% algodón y en un 10% materiales como la seda o el lino.
Cabe aclarar que no existe ningún material no ecológico que sea imposible de reemplazar por uno ecológico.

¿De qué forma dañan el medio ambiente? 

El tejido sintético es plástico. Durante el proceso de fabricación, éste necesita aditivos químicos que también son tóxicos para nuestra piel.
Además, no son biodegradables porque generan las microfibras en los océanos y en los vertederos. ¿Cuál es el costo de producir de manera sostenible?

Por un lado el acceso a materiales, hay pocas opciones de tejido sostenible, y también los procesos se encarecen un poquito más, lo cual dificulta a la hora de vender. 
Por otro lado también hay poco acceso o visibilidad de cara al consumidor. Hay mucha oferta de producción sostenible, pero hay más de la convencional.
De todas formas el problema de la industria textil es multifocal.
Al sobreproducir, por mucho que se produzca de forma sostenible, no es sostenible porque significa el residuo.

"
20/02/2020,Lifestyle,380,98,0,9,487,¿Cumples con tu dosis diaria de frutas y verduras?,"Haz tu propio zumo, natural, sin conservantes y con todas las propiedades de la fruta intactas. Ésta es la premisa de Pulp, un nuevo concepto de zumos en Barcelona. 

Llevar una dieta sana y equilibrada puede resultar algo complicado. En especial, la parte de introducir diariamente una gran variedad de frutas y verduras. Con un zumo podemos beber un trozo de manzana, piña, pera y menta, que posiblemente no consumiremos al escoger cada fruta por separado. 

Con este dilema se encontraron los creadores de Pulp, los zumos 100% naturales que eligen quienes desean cumplir con la listita de lo indispensable para llevar una vida healthy. 

“Carlos, el creador del concepto, era consumidor de zumos y se encontraba una y otra vez con combinaciones de frutas que no se podían modificar y con agua añadida. Juice it yourself es nuestro concepto porque es precisamente lo que queremos transmitir: transparencia y calidad. El producto, la materia prima, todo es flexible, te lo puedes hacer tú, como si estuvieras en tu casa” explica Sara Gesa, project manager. 

La tienda está organizada al estilo nórdico. Entras, eliges tu combinación favorita (a la que le puedes modificar lo que desees), pagas, te preparas el zumo y te lo llevas a tu trabajo, casa, o gimnasio. “Intentamos brindar información y asesoramiento dependiendo de lo que busque cada cliente. Damos a conocer las propiedades y orientamos”. 

“Contamos con productos de temporada y de proximidad. Potenciamos el producto local, porque es más sostenible, reduce la huella de carbono y es una forma de ayudarnos los unos a los otros” cuenta Sara. Como parte de su propuesta sostenible, sus packagings son compostables. 

¿Cómo logran zumos frescos, suaves, ricos y naturales? Porque cuentan con máquinas con sistema Cold press, que no rompen las fibras de las frutas y verduras y logran un resultado cremoso y suave. Las blender en cambio, si las rompen y por ende nuestro cuerpo absorbe solamente un 50% de las propiedades que podría brindarnos. "
23/06/2021,Lifestyle,585,98,29,9,721,¿Es el consumo de carne en España excesivo?,"“España es el segundo país de Europa con mayor consumo de carne y el cuarto productor mundial de porcino’’
Considerado como uno de los mayores productores y exportadores de carne, Cataluña y Aragón son las Comunidades Autónomas que mayores datos registran en materia de producción ganadera de acuerdo a Greenpeace. Ante esta situación, se plantea la cuestión: ¿Debe España reducir considerablemente su consumo de carne?

Según datos del Ministerio de Alimentación, sólo en 2018 en España, la cantidad de carne consumida por persona al año alcanzaba los 50 kg. Durante el año 2020, su consumo aumentó un 6,6%, coincidiendo con los meses críticos de pandemia. El monto aproximado de consumo debería rondar los 20,8 kg al año de acuerdo a Objetivo Bienestar.

La FAO (Organización de las Naciones Unidas para la Alimentación) le atribuye unos datos muy diferentes. En concreto, afirma que el consumo de carne en España supera los 100 kg por persona al año. La diferencia de datos se debe a que la FAO también contabiliza la cantidad que no se llega a consumir o se desecha. Por esta razón, señala al país como el mayor consumidor de carne de Europa, llegando a multiplicar por seis la cantidad de consumo recomendado. 

¿Qué consecuencias medioambientales deja su consumo?
La actividad ganadera ocupa un 30% de la superficie terrestre, lo que ocasiona consecuencias devastadoras en la tierra y en la calidad del aire. Esto genera una aceleración del cambio climático y la erosión de los suelos a raíz de las prácticas que se aplican en la ganadería. 

Según informa Greenpeace, la ganadería emite alrededor de un 14,5% de los gases efecto invernadero, el más relevante: el metano. Este gas, proveniente de los rumiantes y de su alimentación, está considerado como uno de los más contaminantes y nocivos para el medioambiente, dejando una cantidad próxima al 37% de emisiones en el aire. 

La situación es tan alarmante que, entre los años 2015 y 2019, organizaciones como la OMS y Greenpeace advirtieron de la peligrosidad que suponen las producciones industriales de carne. Con esta advertencia no solo querían dejar constancia de los graves daños que ya atraviesa el planeta con estas prácticas, sino también de los daños que el consumo de estas carnes deja en el organismo."
13/07/2021,Lifestyle,297,94,12,20,423,¿Es más caro seguir una dieta vegana?,"Un 1,8% de la población mundial elige seguir una dieta vegana, según Servegano.es. Si bien la cantidad parece ínfima, cada vez son más los que deciden cambiar su forma de alimentación. Una de las preguntas más frecuentes es si se necesita más dinero para poder llevar este estilo de vida.

La base de la dieta vegana son las frutas, verduras, cereales y legumbres. Las cuales son mucho más baratas que los productos de origen animal, como la carne y pescados. Por ejemplo: el kilo de garbanzos no suele pasar los 2€, mientras que el pollo entero cuesta 5,22€. Entonces, ¿Por qué escuchamos a menudo que ser vegano es más caro que llevar una dieta omnívora? La tabla de precios de algunos alimentos de la canasta básica (productos de Mercadona y Carrefour)
Los procesados veganos siguen en debate
Gran parte del mito de que “ser vegano es caro”, viene del consumo excesivo de alimentos procesados. 180 Gr de Salchichas vegetales cuesta 5,25€ ¿Parece elevado? Claro que sí. Una gran parte de los alimentos veganos procesados son costosos para el consumidor. También hay que tener en cuenta la cantidad de productos de origen animal que se están ahorrando.

Los frutos secos, grandes aliados veganos, suelen ser tildados de tener precios disparatados. 150 gr de pistachos son 2€ en el supermercado. Desde la Unión Vegetariana Española proponen frecuentar más las tiendas a granel. Se puede encontrar mayor variedad de alimentos y son más baratos.

Resultaría más costoso ser vegano si no planificas bien tu dieta alimentaria
Llevar una dieta vegana y sana debe planificarse adecuadamente. Elaborar y cocinar tu comida desde cero. No es necesario comer todos los días procesados. Optar por crear recetas, siempre lo casero va a ser más accesible. En la Pirámide de Alimentación Vegana de Igualdad Animal queda expuesta la importancia de la organización de la dieta.

Entonces, lo que afecte a tu cartera dependerá de las elecciones alimentarias que tomes. Si todos los días consumes los alimentos veganos más caros de la góndola, sin duda lo notarás a fin de mes. De igual manera, si estás comiendo productos animales y eliges comer anguila, ostras y caviar a diario. 

También es verdad que dependerá del país en el que vives y la estabilidad económica del mismo. "
30/10/2020,Lifestyle,193,70,6,6,275,¿Industrial o natural? El lado B de la cosmética,"Durante años hemos comprado y utilizado a diario productos cosméticos industriales de laboratorios de renombre, sin saber realmente qué estábamos consumiendo. Lo cierto es que la cosmética funciona igual que el resto de las industrias.

Son muchos los productos cosméticos que contienen componentes como parabenos, sulfatos o aluminio, entre otros, que no son beneficios para nuestro organismo ni para el medio ambiente.

¿Estamos acostumbrados a hacernos el tiempo de leer las etiquetas para analizar qué contiene aquello que vamos a consumir? La respuesta, probablemente en la mayoría de los casos sea; no.

El ejemplo más común de este error que cometemos al no analizar un producto se da con los antitranspirantes. Éstos productos contienen sales de aluminio que sirven para bloquear las secreciones de la glándula sudorípara y dejar de transpirar. El problema es que, además de que transpirar es necesario para el organismo, si no que el aluminio está siendo estudiado como factor asociado a la aparición de cáncer de mama.

Los champús industriales vienen envasados en plástico y además del residuo que genera su envase, contienen componentes sintéticos como los sulfatos, parabenos, siliconas, que no sólo son dañinos para nuestra salud sino también para el medio ambiente. El cuero cabelludo contiene una capa oleosa natural que sirve para proteger el cabello. Los champús industriales arrancan por completo esta capa, y hacen que el cabello luzca primero brilloso y sedoso pero que sea necesario lavarlo muy seguido porque se ensuciará mucho más rápido. En cuanto a su impacto medioambiental, estos productos contienen detergente que contamina el agua.

Una alternativa para reemplazar todos estos cosméticos de manera rápida y fácil es incursionar en la cosmética natural. Éstos productos pueden reemplazarse por champús sólidos, buenos para la salud, el medio ambiente y los animales. También utilizar mascarillas y jabones naturales.

¡Si quieres aprender más sobre lectura de etiquetas alimenticias y cosméticas súmate a los talleres que ofrecemos desde la cuenta de @foodthinkerz!"
17/12/2020,Lifestyle,338,87,17,9,451,¿Qué árbol de navidad escoges?,"Cuando llega la navidad, numerosos hogares del mundo se llenan de luces, decoraciones y árboles. Concretamente árboles de la especie «Abies Alba». O más conocido como: Abeto.

Se estima que esta especie produce en promedio 100 toneladas de oxígeno cada 10 años.
Dado que los abetos son seres, una vez llegan el final de estas fiestas, muchas personas se encuentran con la problemática de: ¿Qué hacer con él?

Muchos ayuntamientos ya cuentan en sus políticas de limpieza y mantenimiento urbano con puntos de recogida. En los cuales, los habitantes, pueden depositar su abeto en estos puestos para su posterior incinerado. Con ello, los ayuntamientos, generan compost para sus propios parques y jardines.

Aunque estos servicios ofrecidos por algunos municipios están pensados para fomentar su compromiso con el medio ambiente y reciclaje, existen muchas formas para crear árboles a partir de otros materiales. De esta manera, conseguiremos unas navidades más ecológicas y fomentaremos la creatividad.

TRASPLANTA

Muchas personas son las que prefieren seguir dándole vida a la planta trasplantándola. Así año tras año, tu abeto irá creciendo y podrás reutilizarlo las veces que quieras.

UTILIZA MATERIALES RECICLABLES

Cada vez son más los hogares que optan por crear abetos con materiales reciclables. Papel de periódico, cartón, entre otros. Antes de desechar un material piensa en cómo darle una segunda vida de una manera creativa.

RECICLA PLÁSTICOS

Una opción también muy viable es utilizar «botellas PET» para crear tu árbol. Su color verde nos aportará un atractivo original a tu abeto y reducirás el desecho de plásticos.

RECICLA PAPEL

Jólabókaflód es el término que hace referencia a una tradición islandesa en la que los días de navidad se pasan leyendo. Pues recurre a los libros que ya no lees para crear un original árbol de navidad y deja a tus familiares sin palabras.

UN AVETO DE ALTURA

Sólo te hará falta una escalera y un par de luces para crear un sencillo y alternativo arbolito navideño. "
6/08/2020,Lifestyle,274,87,20,23,404,¿Sabes leer rótulos alimenticios?,"¿Eres de los que va al supermercado y se detiene a observar qué ingredientes contiene un producto antes de comprarlo?

Lo cierto es que somos poco conscientes de lo que verdaderamente estamos consumiendo. Los alimentos ultra procesados además de hacer daño a la salud humana, hacen daño a la salud medioambiental.

Los rótulos nutricionales alimentarios contienen mucha información valiosa que poca gente comprende cómo entender y desglosar. Es importante entender esta información para alimentarnos de una manera más consciente y poder elegir con criterio y conocimiento a la hora de elegir productos.

La tabla nutricional nos da indicios de cuántos nutrientes y minerales nos aporta. Debemos prestar especial atención a los contenidos de carbohidratos y grasas. En cuanto a los ingredientes, es importante  conocer qué son y saber que se listan de mayor a menor proporción. Es decir el primer ingrediente del listado será el que esté presente en mayor medida en el alimento. Según las encuestas, la mayoría de los habitantes de España no conocen los ingredientes que contienen los alimentos procesados.

En la industria alimentaria se utilizan componentes artificiales que ayudan a producir de manera masiva para que los alimentos se conserven en el tiempo y adquieran cierta textura, estabilidad, aroma, color, etc. Entre los más utilizados están el jarabe de alta fructosa, y edulcorantes como aspartame y acesulfame k, maltodextrinas, almidón modificado y cloruro de sodio. Por lo que debemos idealmente reducir el consumo de alimentos que los contengan.

Así mismo, hay diferentes componentes en los alimentos que impactan directamente en nuestra salud y en la del medioambiente. Algunos son aditivos, los cuales están declarados en el rótulo, como los nitratos, y otros que no lo están, son contaminantes químicos agregados durante la producción: metales pesados, dioxinas, residuos de medicamentos, pesticidas, acrilamida.Estos son algunos contaminantes utilizados comúnmente en la industria alimenticia.

¡Menos es más! La idea es centrarse en consumir alimentos que contengan la menor cantidad de ingredientes posibles. Es decir podemos consumir alimentos procesados, pero debemos aprender a elegir con mejor criterio y  entender que algunos ingredientes son mejores que otros.

Se puede consumir alimentos procesados, pero debemos elegir con criterio y entender que algunos ingredientes son mejores que otros.

Para aprender más sobre cómo leer rótulos alimenticios en tu hogar os invitamos a inscribirse en los cursos de @foodthinkerz"
13/01/2020,Lifestyle,254,81,3,9,347,20 minutos para un cuerpo más saludable,"Muchas veces, no realizamos ejercicio físico de manera contínua porque nos resulta complicado asignarle un tiempo en nuestra atareada vida laboral y social. Peak 8 es un entrenamiento que se caracteriza por ser de muy corta duración y prometer grandes resultados. 

Miriam Machengo, médica especialista en medicina estética y nutrición, nos cuenta de qué trata el “Peak 8” y por qué es beneficioso para la salud.

 “Se tratan de ejercicios de alta intensidad en cortos períodos de tiempo. Lo recomiendo porque libera la hormona de crecimiento; la cual es fundamental para lograr salud, no solamente muscular, si no hormonal”. La deficiencia de esta hormona, agrega la doctora, “es, en mediana edad, la responsable del aumento de grasa corporal y disminución de masa muscular entre otras”. 

20 minutos. Eso es todo lo que requiere esta modalidad de entrenamiento que “permite trabajar el músculo completamente, con sus fibras lentas, rápidas y super rápidas. Éste mejora la salud cardiovascular, que quema más grasa y gana más músculo”. 

¿En qué consta este ejercicio?

Ejercicios intensos, que se realizan comúnmente en caminadora, elíptico o bicicleta fija. Primero hay que realizar un calentamiento de 3 minutos, luego 30 segundos de trabajo duro, y por último 90 segundos de recuperación lenta. Este esquema debe repetirse 8 veces. Para obtener resultados visibles, debe realizarse 3 veces por semana. 

“Todo ejercicio físico debe verse como parte de un estilo de vida y alimentario saludable acompañado de la reducción de azúcares” añade Machengo. "
27/01/2020,Lifestyle,63589,22740,12,250,86591,4 alimentos inteligentes para mejorar la calidad de vida y evitar enfermedades crónicas,"Hay una serie de alimentos -30 en total- que tienen funciones especiales en nuestro organismo. Son alimentos comunes, pero a la misma vez sorprendentes ya que llegan a generar interacciones con el ADN, e incluso pueden lograr que se silencien los genes del envejecimiento. 

Longevity Smart Foods y Protective Smart foods, son, las dos categorías en las que se dividen estos super alimentos según los especialistas Pier Giuseppe Pellicci y Lucilla Titta, autores de «La revolución Smart Foods».

Longevity Smart Foods: influyen en nuestra calidad de vida y longevidad.
Toma nota: alcaparra, berenjena, caqui, cebolla, cereza, chocolate, ciruela negra, repollo morado, cúrcuma, espárragos, fresas, frutos del bosque, ají y pimentón picante, lechuga, manzana, naranja, papa violeta, achicoria roja, té verde y negro y uvas. 

Protective Smart Foods: evitan la obesidad y numerosas enfermedades crónicas. 
Toma nota: aceite de oliva extra virgen, aceites de semillas, ajo, cereales integrales y sus derivados, frutas, verduras, frutos secos, hierbas aromáticas, legumbres y semillas oleaginosas.

Hablemos de cómo funcionan algunos de estos.

Espárrago

Este vegetal, nos ofrece una multitud de nutrientes.Sus tallos contienen vitamina K en grandes cantidades. Además, hierro y vitamina C. Ayuda a la coagulación normal de la sangre y tiene propiedades diuréticas. También contiene ácido fólico, esencial para la síntesis y reparación del ADN y ARN que contribuye a prevenir el cáncer. Este alimento tiene la capacidad de modificar ciertas expresiones genéticas que retrasan el envejecimiento.

Aceite de oliva extra virgen

Protege el corazón y las arterias.Motivo suficiente para consumirlo, ¿Verdad? Los médicos recomiendan cuatro cucharadas de aceite de oliva extra virgen al día. Sí es cierto, que es importante consumirlo crudo. Al freírlo, el aceite se degrada y se activa un mecanismo en el que las grasas buenas se transforman en grasas malas.  ¿Y por qué consumir el virgen extra y no el común? Porque la producción del aceite extra virgen se obtiene únicamente por un proceso de prensado de la uva y no se le realiza un posterior refinado. Al refinar el aceite, se eliminan sus propiedades naturales.

Chocolate negro

Este alimento afrodisíaco, dulce y natural nos ofrece varios beneficios que debemos saber aprovechar. En principio debemos desmitificar el hecho de que es malo consumirlo porque engorda y genera acné. El secreto está en elegir un buen chocolate con los ingredientes correctos. Éste debe tener como base manteca de cacao y al menos un 70% de pasta de cacao. El chocolate posee una acción balsámica en el corazón. Consumir entre 30 y 40 gramos al día ayuda a bajar la tensión arterial, regular los niveles de colesterol y mejorar la elasticidad de los vasos.

Ciruela 

Jugosa, dulce y ácida a la vez. Este fruto funciona como un laxante natural, por su fibra. Además, contiene sorbitol, una especie de azúcar, que equilibra el agua en el intestino grueso ayudándonos con el tránsito lento. La ciruela contiene vitamina C, K, E y minerales como potasio, calcio, hierro y magnesio, que contribuye en mejorar los niveles de anemia. Otro beneficio que nos otorga el consumir ciruela es prevenir la osteoporosis."
19/04/2021,Lifestyle,49,9,66,20,144,70% de los consumidores están dispuestos a pagar más por un producto sostenible,"La nueva normalidad trae consigo la redefinición del lujo.

Hace unas semanas el diario El País compartía un informe de la consultora Llorente y Cuenca en el que se mencionaba que la pandemia había dejado “un consumidor más emocional y más preocupado por los valores que transmiten las marcas”. Esto se debe a que en el último tiempo tanto los consumidores como las grandes marcas de moda han tenido que adaptarse a la nueva realidad.

Hoy podemos decir que hay un nuevo concepto sobre el lujo. Este ha pasado a estar enfocado no solo en el producto, sino también el contexto. ¿Cómo fue producido?, ¿Por quién?, ¿Cuáles fueron las condiciones laborales? Se trata de un concepto más amplio, orientado a la experiencia y al diseño circular, haciendo hincapié en un proceso de fabricación eficientemente energético y sin residuos. 

Si bien es posible decir que la visión del lujo sustentable ha ido creciendo desde un tiempo hasta ahora, en los últimos 12 meses se ha visto un incremento de manera exponencial.

Una de las principales causas ha sido el cambio de mentalidad de quien accede a estos productos, hoy casi el 70% de los consumidores estaría dispuesto a pagar más por un producto sostenible según el estudio de la consultora. Pequeñas marcas de moda sostenible online han dado impulso a esta tendencia, y ahora las grandes apuestan por ello también.

El cambio cultural comienza por las empresas
Son varias las que ya tienen en su agenda comenzar la transición del modelo antiguo de producción a uno que cuide el medioambiente. Eso se ha visto reflejado cuando en 2019, durante la cumbre de G7 en Biarritz, Francia con el “Fashion Pact”. Se trata de un acuerdo que es jurídicamente no vinculante pero que enfatiza en la necesidad de disminuir las emisiones de gases de efecto invernadero y busca hacer más sostenible a la industria. Algunas de las empresas que firmaron este pacto fueron Hermés, Chanel, Selfridge Group y el conglomerado Kering, entre otros. Uno de los grandes ausentes y que representa uno de los porcentajes más grandes de la industria fue el grupo LVMH, quien tiene previsto ingresar para 2025. 

El cambio ha comenzado y está afectando a distintos niveles, tanto a nivel pequeñas y grandes empresas, consumidores e incluso gobiernos, que fomentan las iniciativas como la del «Fashion Pact» durante reuniones de alta política como el G7.

El nuevo contexto ha redefinido los valores que tienen los compradores la hora de adquirir nuevos productos y servicios en el sector del lujo, ahora el foco se ha puesto más en la transparencia en el proceso de producción y en las diferentes fases de la cadena productiva más que en el producto terminado. 

Es un cambio que llevará tiempo si, pero podrá conducirnos también hacia un mundo más sostenible."
1/03/2021,Lifestyle,1608,507,69,52,2236,Abre el primer supermercado plastic free en España,"LINVERD, el primer supermercado plastic free abre en España. Esta cadena asegura estar comprometida con la completa eliminación de plásticos en la industria alimentaria. 

Esteve Doménech y Jordi Vives son los propulsores de este nuevo concepto de supermercado que busca conseguir un consumo responsable sin necesidad de generar residuos. La idea de estos dos emprendedores, surge del modelo de vida de Esteve; publicista especializado en comunicación interna para supermercados, muy dado a la vida saludable y comprometido con el medioambiente.

La propuesta del primer supermercado plastic free en España es ’’Ayudar al consumidor a vivir mejor y que sea cómplice de la regeneración de la tierra’’. En sus instalaciones podemos encontrar desde vinos, frutos secos a fruta. Más adelante, desean incorporar carnes y pescados. Además, en el interior del establecimiento, cuentan con un pequeño espacio dedicado al cultivo de lechugas y plantas comestibles. Un total de 25 proveedores ya colaboran con este nuevo concepto de comercio alimentario.

Hola plastic free y adiós a los plásticos de un solo uso
’’Se estima que, la industria de la alimentación dejó en 2020, alrededor de 500 mil toneladas de residuos provenientes de los productos consumidos, 200 mil más que en 2016’’, según Greenpeace.
Un estudio de la misma organización en 2019, decía que, 3 de cada 8 supermercados apuestan por medidas sostenibles. En España, una falta de legislación y de compromiso, hacen que sus supermercados aboguen por una mentalidad de sustitución, pero no de eliminación de plásticos en sus establecimientos. España ocupa la 5ª posición de países productores de plásticos de la Unión Europea.

Los plásticos de un solo uso, no son fáciles de degradar. Se calcula que, un material de este tipo abocado al mar, tarda una media de 500 años en deshacerse. Y unos 600, en un medio terrestre.

Linverd es el primer supermercado de España comprometido con el objetivo que Greenpeace fijó para 2025: La eliminación de plásticos de un solo uso. Cada uno de sus productos son envasados y envueltos, en papel o vidrio.

Empresas como: Eroski, Lidl o Alcampo, ya cuentan con planes sostenibles para reducir los plásticos en sus packagings y lideran el ranking de comercios sostenibles. Por otro lado, cadenas como Mercadona se plantean reducir hasta en un 25 %, la presencia de plásticos en sus establecimientos."
18/05/2021,Lifestyle,864,185,78,3,1130,"Agricultura Ecológica, la propuesta del Plan de Acción Europeo","El mes pasado, se presentó en el país el Plan de Acción Europeo para la Agricultura Ecológica 2021/2027. Su finalidad será aportar al sector de la agricultura ecológica las herramientas que permitan impulsar el consumo, aumentar la producción y seguir mejorando la sostenibilidad del sector.

El Plan de Acción pretende que la producción ecológica sea accesible a todas las personas a través del aumento de la superficie ecológica e incentivando el consumo de productos ecológicos locales. Para supervisar su evolución, la Comisión organizará reuniones públicas anuales de seguimiento e informes de progreso.

Según los datos de la Comisión, la agroecológica en territorio europeo ha aumentado casi un 66% en los últimos 10 años – de 8,3 millones de hectáreas en 2009 para 13,8 millones de hectáreas en 2019. Actualmente representa el 8,5% del total del “área agrícola” de la UE. 

¿Qué es la agricultura ecológica?
Greenpeace España, la define como el único método de agricultura que busca la armonía entre el funcionamiento de los sistemas naturales y los intereses del ser humano. Su resultado son alimentos saludables producidos de una manera sustentable.
La misma se basa en tres pilares; la biodiversidad, el no utilizar productos químicos, y que el laboreo de la tierra sea el mínimo posible.

Las alternativas a gran escala
Existen empresas biológicas, que proponen utilizar insectos “come plagas” como alternativa a los pesticidas en cultivos. Es decir, el control de plagas se realiza de forma natural mediante la potenciación de los sistemas naturales de control (sus enemigos naturales). “El problema con algunas plagas es que es posible que con el tiempo se genere resistencia” explica Ana Arévalo, técnica de campo en el control biológico de las plagas, en La Sexta Equipo de Investigación.

Para las plantaciones a gran escala, se vuelve más necesario el uso de químicos. Esto sucede especialmente con las plagas de hongos, que al no tener depredadores naturales, resulta más difícil no utilizar pesticidas.

¿Qué sucede con los pequeños productores?
Orense, es el lugar donde se produce el 90% de la patata gallega. Hoy en día estos productores se encuentran muy afectados por la prohibición del Clorprofam; pesticida que según la UE, produce efectos nocivos para la salud.

Los pequeños agricultores temen que la prohibición del químico ponga en riesgo la supervivencia de su producción. Lo cierto es que hay alternativas más ecológicas, como el aceite de menta. Pero éste es más costoso y no tiene la misma efectividad que el Clorprofam.

Al menos hasta el momento en España el agricultor puede elegir cómo producir.  Si decide hacerlo de manera ecológica, deberá tener en cuenta algunos aspectos como el tamaño de su terreno y los costos que esta práctica implica en su rentabilidad.

El objetivo del Plan de Acción Europeo es claro: informar y estimular el consumo de productos ecológicos. Gran parte de la responsabilidad la llevan los consumidores a la hora de escoger los productos por sus nutrientes, beneficios y origen, y no su aspecto."
22/10/2021,Lifestyle,276,43,6,6,331,Alimentación infantil sostenible en comedores escolares,"El Ayuntamiento de Barcelona hacía público hace un año un proyecto de alimentación infantil sostenible, que se ha implementado en un total de 36 colegios de la ciudad. La iniciativa pretende reducir el consumo de carnes rojas en los comedores escolares. El proyecto ‘‘Menjadors escolars més sans i sostenibles’’ cuenta con el apoyo de la Agencia de Salut Pública y el Consorci d’Educació de Barcelona. Y aunque esta actividad lleva vigente desde el pasado año, lo cierto es que cada vez más escuelas se están sumando a la iniciativa.

Con este proyecto de alimentación infantil sostenible se quiere promover la economía local, combatir la emergencia climática y unas prácticas más sostenibles de alimentación durante las primeras etapas de una persona. Además, esta iniciativa forma parte del nombramiento de Barcelona como Capital Mundial de la Alimentación Sostenible 2021.

Un 80% de la población infantil y adolescente no come suficientes frutas y hortalizas
Estas nuevas prácticas de alimentación en comedores escolares se basan en minimizar al máximo el consumo de proteína animal y sustituirla por proteína vegetal. Uno de los colegios donde esto ya es una realidad, es en el colegio de educación infantil y primaria La Farigola. En declaraciones al medio 20 Minutos, el personal de cocina del centro afirma que ya se han eliminado de sus cocinas cualquier alimento como verduras y frutas procesadas y apuestan por productos ecológicos de la zona.

‘‘Según un estudio de la Agencia de Salud Pública de Barcelona, alrededor del 13% de niños catalanes de entre 8 y 9 años ya sufren obesidad infantil. Este plan pretende concienciar tanto a niños como a padres’’.
El proyecto cuenta con las indicaciones de expertos nutricionistas, que elaboran planes nutricionales para infantes y jóvenes que persiguen una nutrición completa, saludable y sostenible.

Los problemas de la alimentación infantil en el mundo
Uno de los mayores problemas mundiales es el excesivo consumo de proteína animal, problema también muy vinculado a etapas tempranas del ser humano. España es uno de los más señalados por organizaciones como Greenpeace. Hacia 2025 existirán 7 millones de niños menores de 5 años con sobrepeso si no se reeduca en materia alimentaria, según informa la OMS.

Organizaciones como la Fundación del Sueño y la Asociación de Pediatría Española recomiendan combinar una buena nutrición con descanso adecuado y actividad física, ya que en los últimos años se ha detectado un incremento del sedentarismo infantil, provocado por las pantallas y un excesivo consumo digital."
16/12/2019,Lifestyle,58,43,3,30,134,Apps para reducir la huella de carbono,"¿Qué pequeños cambios podemos hacer diariamente para cuidar el medio ambiente y nuestra propia vida?

9 de cada 10 personas respiran aire contaminado en el mundo. Te compartimos una lista de opciones para reducir la huella de carbono y tomar conciencia sobre el impacto que tiene en nuestra salud.
 Go Green: Carbon Tracker
Soluciones para reducir nuestro impacto ambiental

¿Somos ecofriendly? Lo descubriremos gracias a esta aplicación, con la que podremos calcular la huella de carbono de forma diaria o semanal.
Además de informar, provee soluciones para reducir nuestro impacto ambiental. 

¿Cómo ahorrar energía? ¿Cómo tener un comportamiento sostenible? ¿Qué actividades realizamos diariamente que afectan al clima y podemos cambiar? ¿Cómo transportarnos y reducir el impacto? Estas son algunas de las preguntas que podremos resolver.

Plume Air Report
Información sobre contaminación en tiempo real

Para crear esta aplicación, científicos especializados en datos atmosféricos crearon un modelo que utiliza datos satelitales para identificar la calidad del aire a nivel mundial en todas las áreas urbanas del mundo.

Al igual que consultamos el clima diariamente, podremos hacerlo con la calidad del aire en tiempo real y con un pronóstico de las próximas 24 horas. 

¿Cómo puede ayudarnos esta app? En tomar decisiones sobre en qué momento del día salir a correr, realizar cualquier actividad física o simplemente dar un paseo sin exponernos a la contaminación.

La premisa es respirar un aire más limpio.

Breezometer
Calidad del aire estemos donde estemos

Funciona muy similar a Plume Air Report. Esta app mide la calidad del aire en cualquier lugar y más importante aún: su nivel de limpieza. Activando la ubicación, podremos tener toda esta información al momento. Es ideal para aquellas personas que viajan mucho.

Dentro de la aplicación, se puede acceder también a una función para conocer la calidad del aire por zonas.

Trucos ecológicos
Consejos para aportar nuestro granito de arena

Su nombre lo dice todo. Además de calcular nuestro impacto en el medio ambiente evaluando la huella de carbono, nos aporta maneras simples de marcar la diferencia. Hay más de 300 consejos ecológicos y económicos.

Lee también ¿Cómo cuidas el planeta? Apps ecofriendly
"
28/07/2021,Lifestyle,303,110,18,3,434,Autoconsumo fotovoltaico: genera tu propia electricidad,"El 79% de la población española sólo produce un 3% de la energía que consume,  según un informe elaborado por la Fundación Renovables y Otovo. En los municipios con más de 10.000 habitantes se dan incentivos fiscales para las instalaciones de autoconsumo fotovoltaico. ¿El fin? motivar a los ciudadanos a generar su propia electricidad. 

No es novedad que las urbanizaciones son el foco principal emisor de Gases de efecto invernadero (GEI). Una alternativa para reducir la huella de carbono es el autoconsumo fotovoltaico: crear la energía de tu vivienda a través de paneles solares. 

El autoconsumo fotovoltaico no solo es sostenible, sino también rentable a largo plazo
¿Tiene sus ventajas? claro, muchas. Para empezar, la energía que usarás será renovable. Se termina la dependencia, como consumidor, con los principales distribuidores de electricidad. Es cierto que la inversión inicial de dinero para instalar las placas solares será grande. Cuesta entre 600€ y 800€ por metro cuadrado, según Idealista. Pero a fin de mes te ahorrarás la factura de la luz.

Además, se ofrecen bonificaciones fiscales. Las administraciones públicas reducirían impuestos como el IBI (Impuesto de Bienes Inmuebles) y el ICIO (Impuesto de construcciones, instalaciones y obras) a quienes tengan estas instalaciones de autoconsumo.  

De los 753 municipios analizados en el informe, 312 ofrecen bonificaciones en el IBI, y únicamente 231 en ambos impuestos (IBI y ICIO). La población de estos municipios representa un 47% del total de la población residente en España. Por lo tanto, la posibilidad de las ayudas económicas existe, pero por desconocimiento u otros motivos, muchos ayuntamientos no las aplican.  

Si bien estas ayudas son efectivas, el gobierno podría incentivar aún más. “Una medida sencilla, directa y clara para los ciudadanos sería un IVA reducido del 10%, en instalaciones de autoconsumo”, propone el CEO de Otovo, Iñigo Amoribieta al Periódico de la Energía. 

Bruselas pide que en una década se multipliquen las energías renovables de Europa
La UE busca dejar fuera de la circulación a los vehículos más contaminantes, penalizar a los edificios (incluidas las viviendas habituales) que no limiten sus emisiones de CO2 y encarecer las importaciones desde países que no cooperen en la lucha contra el cambio climático, advierte en El País.

Para llegar a esta fecha cumpliendo lo pedido, se requerirá de un trabajo conjunto. Por su parte, las autoridades tendrán que usar su potencial como motor para el cambio. Seguir generando ayudas. A su vez, tanto el sector empresarial como los ciudadanos deben informarse de los beneficios y del coste que implica instalar y generar su propia energía. 

El momento es ahora, la crisis climática está aquí y 10 años no son nada."
19/12/2019,Lifestyle,133,40,3,23,199,Beneficios de vestir vintage,"Las modas no solo vienen dadas por los laboratorios de tendencias, si no por necesidades mundiales, entre ellas y hoy con mayor relevancia que nunca, por la crisis climática que enfrentamos.

El modelo de economía y consumo lineal en el que se extraen materias primas, se produce, se distribuye y se vende; para volver a iniciar el círculo indeterminadamente ha de acabarse y el motivo es muy simple: todo termina en desecho.
El fast fashion, la tendencia de consumir ropa constantemente sin darle un valor y apostar – probablemente inconscientemente – por el consumismo, ha empezado a perder popularidad y la moda vintage vuelve a ser protagonista de las calles.

¿Cuáles son los beneficios de vestir vintage? Te lo contamos.

Reduciremos las emisiones de CO2.

Evitaremos los químicos que contaminan los suelos y ríos.

Contribuíremos en recortar el uso de combustibles fósiles.

Limitaremos el uso de recursos limitados. En la extracción de recursos naturales muchas veces se utilizan materias primas que no son bienes renovables o que tardan años en regenerarse.

Consumiremos productos de mejor calidad. Las grandes compañías fabrican masivamente con costes de producción cada vez más bajos por la utilización de materiales de calidad cada vez más baja."
4/06/2020,Lifestyle,55,46,3,49,153,"Bolsas compostables, ¿Cómo utilizarlas?","Es resistente, es práctica, suficientemente higiénica y barata -de hecho, en la mayoría de los casos incluso es gratis-. La utilizo hoy, solo hoy, y luego la tiro. Podría guardarla pero ¿Para qué? Mañana seguramente me darán una nueva. 

Esta suele ser la vida útil de una bolsa plástica, y de otras tantas millones de toneladas de productos del mismo material. Según un informe del 2018 de la ONU Medio Ambiente “Plásticos de un solo uso: una hoja de ruta para la sostenibilidad”, en el 2015 se generaron 300 millones de toneladas de residuos plásticos.

Si bien al menos 127 países aprobaron distintas leyes que regulan el uso de las bolsas plásticas de un solo uso, este mismo informe estima que por año se consumen entre uno y cinco billones de las mismas. 

Y, aunque los números ubicados en breves párrafos resulten fríos y distantes, representan una realidad mucho más cercana: la constante contaminación que generamos sobre nuestros suelos, aguas y animales tanto terrestres como marinos. 

Frente a la innegable evidencia científica sobre los impactos medioambientales y sociales que tienen las bolsas plásticas derivadas de combustibles fósiles, desde hace algunos años existen otras alternativas más amigables con el medioambiente, pero sobre las que igualmente debemos tener ciertos recaudos. 

Un opción posible, si se la utiliza adecuadamente
Las bolsas compostables son aquellas fabricadas de tal manera que, después de un periodo de tiempo y bajo determinadas condiciones materiales y de temperatura, se descomponen completamente. Están elaboradas a partir de materia orgánica, lo que hace posible su biodegradación y transformación en lo que se conoce como compost. 

El compost, entonces, es el producto que se obtiene de la desintegración total del material orgánico y que se utiliza como fertilizante. 

¿Cómo utilizarlas?
Si bien opciones como esta parecieran encajar perfectamente con el enfoque de la economía circular, debemos estar atentos a la hora de informarnos sobre su funcionamiento. De acuerdo con un informe de Greenpeace de septiembre de 2019, los plásticos biodegradables solo representan el 1% del plástico disponible en el mercado. Además se advierte que no es necesariamente cierto que este tipo de bolsas se descomponen naturalmente. Muchas veces, para que el proceso ocurra se requieren condiciones de calor y humedad que rara vez se encuentran en el medio ambiente de forma natural.  

También se asegura que estas bolsas no son siempre 100% naturales, ya que en algunos casos su proceso de fabricación puede involucrar agregados químicos, similares a los utilizados en las bolsas plásticas convencionales.  

Grandes empresas constantemente colocan términos como “biodegradable”, “eco-friendly” o “verde” en sus productos como estrategia de marketing, cuando en realidad no cumplen con los requisitos necesarios. Por ello, informarse y educarse en el tema es sin dudas el abordaje más seguro e inteligente cuando del cuidado de nuestro medio ambiente se trata."
16/03/2020,Lifestyle,709,210,6,15,940,Buena alimentación para defendernos del coronavirus,"El coronavirus es una realidad que está afectando a la población mundial. Además de las recomendaciones básicas para evitar el contagio, podemos incorporar algunos hábitos para reforzar nuestro sistema inmunológico, que es el que finalmente acabara enfrentándose al mismo. 

Un cuerpo alcalino, es un cuerpo sano. Cabe aclarar que hoy en día no disponemos de ninguna fórmula milagrosa que nos permita ser inmunes a las enfermedades. Sin embargo, tener una buena alimentación con un ph a su nivel óptimo y mantener hábitos de vida saludables, son cuestiones fundamentales para mantenernos más sanos y fuertes. La dieta alcalina, fortalece nuestro sistema inmune. Esta asegura que las células de nuestro cuerpo, tengan oxígeno, vitaminas y minerales.

Los científicos del TEC de Monterrey aconsejan consumir ciertos alimentos para mantener el organismo en estado alcalino, estos son:

Jugo de limón, lechuga, pepino, espinacas, algas, palta, naranja, ajo, té verde, jengibre, almendras crudas, remolachas, zanahorias y manzanas.

Además de consumir alimentos que nos ayuden a mantener un ph alcalino en nuestra sangre, algunos de ellos refuerzan directamente nuestro sistema inmunológico. Los ricos en omega-3, selenio, zinc, pro bióticos, vitaminas A, C y E, aumentan nuestras defensas. También favorecen la producción de glóbulos blancos en el organismo. 

Chocolate negro puro, altamente rico en zinc. 
Yogurt, alto contenido de vitamina A
Ají rojo, alto en vitamina C.
Salmon, rico en Ácidos Grasos Omega 3, proteínas y Vitamina D  
 Espinacas, ricas en vitamina C.
Entonces ahora sabes que, además de tomar las precauciones sanitarias para prevenir el virus como lavarte las manos regularmente, mantener un metro de distancia con la gente y permanecer aislado, se aconseja llevar una dieta rica en vitaminas y minerales y mantenernos activos, realizando algo de actividad física diariamente. De esta manera tendremos una herramienta más para hacerle frente a esta situación."
10/12/2019,Lifestyle,90,43,0,29,162,Buscadores amigables con el mundo,"Conectar el mundo digital con el medio ambiente es posible. 

Un estudio del 2019 de la consultora Zenith Media en 50.000 usuarios de 16 a 60 años de edad en 46 países, reveló que pasamos en promedio ocho horas diarias en internet.
A partir de este dato nos preguntamos, ¿Qué partido podemos sacarle a este uso constante que hacemos de este medio?

A continuacion, 2 buscadores para contribuir al cuidado del medio ambiente en nuestra vida cotidiana.

Ecosia: el buscador que planta árboles
Ya se acercan los 80.000.000 de árboles plantados por esta plataforma cuyo objetivo es plantar 1.000 millones en 2020. La premisa es simple, nosotros debemos hacer búsquedas en internet, clickear en ads, y la empresa destina el 80% de sus ingresos a plantar árboles.   

Para plantar un árbol, piden a los usuarios una media de 45 búsquedas. 

Éste puede ir a distintas partes del mundo. Ecosia da soporte a 20 proyectos de plantaciones en 15 paises: Perú, Brasil, Madagascar, Nicaragua, Marruecos, Haiti, Ethiopía, Tanzania, Kenya, Indonesia, Ghana, Colombia y España. 

¡Dispone de una extensión para añadirlo a Google Chrome!

Goodsearch: el buscador de las ongs por el planeta y los derechos humanos
Se estima que de sus ganancias, se dona el 50%. Estas donaciones, están destinadas a más de 100.000 organizaciones entre las cuales podemos elegir. Muchas de ellas están dedicadas a proyectos medioambientales, mientras que el resto son ongs reconocidas como Unicef, American Red Cross. 

¿Cuál elegirás?"
10/08/2021,Lifestyle,133,44,32,9,218,Cambiar el mundo a través del agua: una utopía realizable,"El agua es un recurso esencial para el desarrollo sostenible de las poblaciones y de los ecosistemas. Sin embargo, una de cada cuatro personas en el mundo no tiene acceso a agua potable.

Como única salida -dada la falta de acción de los gobiernos- la mayoría de los individuos adapta su consumo a la compra de agua embotellada. Esto genera, junto a otros residuos, una acumulación anual de más de 8 millones de toneladas de plástico en nuestros océanos.

Agua sostenible, libre de plástico
PURA, la nueva empresa B Corp de España, llega a Barcelona para democratizar el acceso a agua de calidad. El propósito de la empresa es cumplir con dos objetivos de desarrollo sostenible: democratizar el acceso a agua de calidad y conservar los ecosistemas marinos.

“Barcelona es la ciudad con mayor consumo de agua plástica por habitante. Es inconcebible que una botella de plástico venga de Francia, desconociendo si el agua estuvo en contacto con el sol, si tiene microplásticos, habiendo la posibilidad de generar en el propio territorio agua de muchísima mejor calidad”, sostuvo en diálogo con Econews Today, Leandro Barrionuevo, Director y socio-fundador de la empresa. 

Para medir científicamente el impacto ambiental que tiene el agua libre de envase, PURA realizó en 2018 una investigación junto con el INTI (Instituto Nacional de Tecnología Industrial Argentino):

Producir 2 litros de agua embotellada genera 235 veces más calentamiento global que el agua consumida con purificadores.  
Ser la mejor empresa para el mundo y no sólo del mundo
La responsabilidad socio-ambiental de PURA llevó a la empresa a ir un paso más allá y en 2018 logró la certificación B como resultado de un proceso de evaluación de impacto desarrollado por la organización sin fines de lucro B-Lab.

Así es como la empresa se incorpora al movimiento global de comunidades responsables que cumplen con los más altos estándares de desempeño social y ambiental verificados, y que ya alcanza a más de 3.500 empresas en 70 países diferentes. 

PURA, que este año logró ser carbono positivo al capturar de la atmósfera más CO2 del que libera, hoy se enfrenta a un desafío mayor como organización: conceder participación accionaria a cada colaborador dentro de la empresa. 

En un contexto de agravamiento de la desigualdad social y de la destrucción de los ecosistemas, hay empresas dispuestas a actuar diferente. Todos somos parte de este proceso de transformación. Y es uniendo esfuerzos que podrán abrirse las puertas hacia sociedades más justas y sostenibles.

Os invitamos a conocer mas de Pura en su sitio web: www.globalpura.com.es o en sus redes sociales @pura.spain"
20/01/2020,Lifestyle,148,139,3,9,299,Cambiar nuestra alimentación en favor del medio ambiente,"A diario consumimos alimentos, probablemente sin considerar las consecuencias de nuestra elección para el medio ambiente. Los procesados, llevan consigo una serie de tratamientos que generan desechos y consumen grandes cantidades de energía y agua.
La producción masiva de alimentos requiere el uso de aditivos, entre otros compuestos y métodos de procesamiento, para producir mucho en poco tiempo y además para que éstos duren más.  

El aceite refinado de oliva es un claro ejemplo del daño que un producto provoca en el medio ambiente. El proceso de refinamiento se realiza para quitarle al aceite ciertos componentes que hacen que se deteriore rápidamente, aunque éstas sean beneficiosas para nuestro organismo, como los ácidos grasos libres. 

La coincidencia se encuentra en que, por lo general, aquello que es dañino para el planeta también lo es para nosotros. 
Al refinar el aceite, muchas propiedades naturalmente saludables, como vitaminas, se pierden. Además, el proceso genera desechos. El aceite de oliva extra virgen, en cambio, solamente requiere el proceso del prensado de la uva para extraer el aceite. Éste no genera desechos y el producto permanece rico en nutrientes ya que conserva sus ácidos grasos buenos, vitaminas y antioxidantes, entre otros. 

Ejemplos como éste hay un montón. Cada producto industrializado implica un proceso de pérdida de propiedades y males ambientales. La industria alimenticia está en la búsqueda de nuevos métodos para aminorar los residuos y el gasto de agua y energía. 

¿Cómo podemos contribuir en el cuidado del medio ambiente?

Deberíamos disminuir el consumo de productos ultra procesados y el desperdicio de alimentos. Consumir menos en los supermercados y más en los mercados. También, reducir la compra de carne y aumentar la de cereales, legumbres integrales, frutas y verduras de estación. Así, daremos pequeños pasos que se transformarán en mejores hábitos y grandes cambios."
31/12/2019,Lifestyle,320,147,0,9,476,Centella asiática: la clave para una piel perfecta,"¿Qué es? ¿Qué beneficios trae? ¿Cómo aplicarla?
Te contamos todo sobre esta planta que cada vez reúne más fanáticos.

La centella asiática es una planta utilizada comúnmente en la medicina tradicional china, que comenzó a comercializarse hace ya varios años en América Latina y gran parte de Europa pero que ha ganado popularidad en los últimos años debido a su producción en distintos formatos.
Esta planta de origen indio, posee miles de propiedades medicinales para todo tipo de piel y edad.

Propiedades

Diurética, antioxidante, astringente, antiséptica
Fomenta la producción de colágeno natural de la piel
Cicatriza y desinflama
Mejora la circulación de la sangre
Reduce la celulitis al cabo de 2 o 3 semanas
Previene la aparición de estrías
Forma de aplicarla o consumirla

En comprimidos
Se vende en blisters que contienen la sugerencia de ser consumidos-en líneas generales- entre 1 y 2 comprimidos diarios. 
En cremas, lociones o geles
Masajeando con movimientos circulares ascendentes.
En ensaladas, batidos o infusiones
Esta es una buena alternativa para consumirlo de la forma más natural posible. Se puede conseguir en dietéticas."
11/05/2020,Lifestyle,533,87,0,144,764,Circular: la clase de economía que funciona,"Producir, utilizar y desechar son acciones que ya no podemos realizar. El paradigma del modelo económico lineal no es sostenible a largo plazo. Debemos cambiar el modelo de producción y dentro de las opciones disponibles, la economía circular resulta ser la mejor solución.  Reducir, reutilizar y reciclar.

En la naturaleza no existen los residuos ni vertederos. Todos los elementos cumplen una función de forma continua y son reutilizados. Como se suele decir, la naturaleza es sabia. 

El modelo que propone la naturaleza
Es un modelo económico cíclico, donde se toma como ejemplo el ciclo de la naturaleza. Los recursos son aprovechados al máximo, aunque siempre se prioriza la reducción de los elementos. Esto es, minimizar la producción y consumo de recursos al mínimo indispensable y apostar por la reutilización de los elementos del producto una vez que finalice su vida útil. 

Dicho de otra manera, la economía circular apoya la utilización de la mayor parte de materiales biodegradables posible para que al desecharlos no produzcan un daño ambiental. Cuando los materiales no puedan ser eco-friendly (elementos electrónicos, metales, baterías…) debe asegurarse un desacople sencillo. Así, algunas partes se utilizan para crear una pieza nueva. Cuando ninguna de estas alternativas es posible, este producto es reciclado. Cuando esto no puede llevarse a cabo, se aprovechan energéticamente los residuos que no pueden ser reciclados.

Trae beneficios para todos
Este modelo económico propone el equilibro entre los factores económicos, sociales y ambientales. De esta manera obtienen beneficios tanto los consumidores como los productores.
Al aplicar la economía circular las empresas reutilizan recursos, en lugar de crearlos desde cero, de forma que se obtiene como resultado un proceso mucho más rentable.

Principios que la rigen
Minimizar la polución y los desperdicios

La contaminación y los residuos que un proceso genera son el resultado de la eficiencia desarrollada en la etapa de diseño del mismo. Cuanto más cerca del origen del proceso se trabaje para tener un proceso eficiente, mejor será el resultado.
Mantener productos y materiales en uso

Es fundamental que los materiales usados puedan volver a usarse, o ser reparados, en lugar de ser descartados inmediatamente. 
Regenerar sistemas naturales

Aunque se procure evitar desgastar la naturaleza, indefectiblemente ocurre. Es por eso que se debe fomentar crear o regenerar los ecosistemas, devolverle a la tierra sus nutrientes.
Pensamiento crítico

Se debe siempre tener en cuenta los resultados tanto a corto, mediano y largo plazo. 
La economía circular nos impulsa a mejorar nuestros hábitos de consumo, adquirir productos cuyo origen asegure condiciones dignas y responsables con el cuidado del ambiente. A comprar lo que se necesita, lo justo y necesario, sin generar desperdicios evitables.

La economía circular es evolucionar hacia una economía sustentable, donde los aspectos económico, social y ambiental tengan el mismo nivel de prioridad. Una economía más justa para las personas y el planeta.
¡Reduce, reutiliza y recicla en casa!"
14/07/2021,Lifestyle,516,104,63,26,709,Climatización pasiva: hogar climatizado sin dañar al planeta,"10% del consumo de electricidad mundial corresponde al uso del Aire Acondicionado, según la IEA (Agencia Internacional de Energía). Estos números que van en ascenso repercuten directamente en el calentamiento global. Una alternativa posible para frenar la escalada son los sistemas de climatización pasiva. 

Con la llegada del calor, vienen las ganas de tener tu hogar climatizado, refrigerado principalmente. El aire acondicionado es un gran aliado del verano, pero también tiene sus desventajas.

Cuando prendemos este aparato el aire frío no sale automáticamente. Primero los líquidos refrigerantes deben captar el calor del ambiente y enfriar la temperatura del lugar, entre otros procesos. Mientras tanto se va expulsando el aire caliente al exterior de la vivienda. Así, al prender un AC se contribuye a aumentar la temperatura del planeta. Que contradicción ¿no? nos enfriamos calentando la tierra.

Passivhaus, ventilación eficiente y ahorrativa a largo plazo
Se conoce como climatización pasiva a gestionar la temperatura interior de una casa sin aumentar el consumo de energía. Es decir, no se utilizan fuentes de energía tradicionales o dispositivos auxiliares. Se basa en aprovechar las fuentes de energía y calor que se presentan de forma natural. 

Según Arquitecturatecnica.es las casas pasivas o passivhaus se rigen por una serie de condiciones bastante estrictas en cuanto al uso de energía. Es por eso que la climatización es un punto que se tiene en cuenta desde que se empieza a construir la casa hasta el momento de habitarla. Estas se diseñan para aprovechar al máximo los recursos del entorno, generando el menor impacto ambiental y dependencia energética. 

El Colegio Brains, en Madrid, ha apostado por la certificación Passivhaus Plus para convertir su nuevo centro en un referente de sostenibilidad, aseguran desde El Economista. Así se convierte en el primero en España con obra nueva en cumplir con los requisitos de eficiencia energética.

Entonces, ¿Cómo hacer para que tu hogar tenga climatización pasiva?

La aerotermia te da un hogar climatizado de forma sostenible y ecológica.
Los equipos de aerotermia obtienen casi un 80% de su energía del exterior (gratis), y el resto de forma eléctrica. Utiliza la energía del aire para climatizar el espacio. Se la usa como calefacción, refrigeración y producción de agua caliente sanitaria. Básicamente se instala una bomba de calor que extrae la energía para convertirla en calor o frío. A diferencia de los aires acondicionados no propagan humo, ni combustión interna. 

Entre 6.000€ y 7.000€ costaría instalar esta tecnología en tu hogar, estiman en Instalaciones y eficiencia energética. Incluiría una bomba de calor aire-agua de 19kw, grupo hidráulico, depósito de inercia de 100 litros y montaje. Tampoco hay que olvidarse del suelo radiante, considerado un must en una casa climatizada pasiva. Por lo contrario comprar un aire acondicionado sale alrededor de 450€ en El Corte Inglés.

También es importante el uso adecuado de la vegetación. Los muros verdes en las instalaciones actúan como aislantes térmicos, dan sombra, enfrían y funcionan como filtros solares.

En definitiva, en la inversión inicial un equipo acondicionado es más económico, pero hay que sumarle la electricidad que requiere. Será clave que los usuarios hagan uso responsable de la tecnología que tengan, sobre todo de los AC. Nuevamente queda en manos del consumidor elegir como climatizar su casa, pensando o no en su efecto futuro sobre nuestro planeta."
2/04/2020,Lifestyle,404,1.780,14,9.437,11635,Cómo aplicar las 3R en nuestro hogar,"Las 3R de la ecología: Reducir, Reutilizar y Reciclar son vitales para una mentalidad ecológica. La propuesta promueve tres pasos básicos para disminuir la generación de residuos y el consumo energético con el fin de preservar el ambiente. 

Respetar su orden resulta fundamental. ¿Lo primero? Enfocarse en reducir el consumo de lo evitable y de la generación de residuos. Luego, reducir lo inevitable. Y como última alternativa, el reciclaje será la opción. 

En un contexto donde el coronavirus tiene al mundo detenido, con las fábricas e industrias cerradas y la población confinada, puede ser el momento ideal para reflexionar sobre el impacto que tienen en el ambiente los bienes y servicios que son consumidos diariamente.

¿Cómo aplicar en nuestras casas la filosofía de vida que las 3R promueven?
Reducir

Cuando se habla de reducir el foco está puesto en los productos con vida útil corta. Esto significa tratar de reducir o simplificar el consumo de productos que se compran, consumen y son descartados rápidamente. Es también elemental el consumo responsable del agua y energía.

Consejos sencillos para aplicarlo:

Utilizar lavarropas y lavavajillas llenos y no a media carga.
Limitar el tiempo de ducha a 2 canciones (no vale que sea Bohemian Rapsody).
Escoger alimentos naturales y dedicarle tiempo a cocinar. Que la premisa sea “más cáscaras, menos envoltorios”.
Llevar una bolsa de tela al realizar las compras.
En vez de comprar varias botellas pequeñas de una bebida, comprar una grande.
Reutilizar 

El hábito de reutilizar ayuda a alargar la vida útil de un producto.  Antes de tirarlo y sustituirlo por uno nuevo, buscar la manera de repararlo o, de no ser posible, darle un nuevo uso. Es hora de aprovechar el momento dentro de casa para reparar todo lo postergado por falta de tiempo, de ser creativos y animarse a innovar para encontrar nuevos usos a los que serían descartados. 

Algunos ejemplos: 

Regar las plantas con el agua utilizada para lavar frutas y verduras, o que sobra después de beber.
Utilizar frascos de vidrio para conservar alimentos comprados a granel, organizador de cubiertos, vasos o hacer terrarios.
Compostar los residuos orgánicos para obtener tierra fértil para las plantas o huerta.
Reciclar 

El reciclaje es la última instancia, cuando las dos previas ya fueron puestas en práctica, donde los objetos perdieron su funcionalidad pero se podrían obtener nuevos productos a partir de ellos. 

El reciclaje funciona en cadena, por lo que lo esencial es separar los residuos generados y disponerlos de la forma correcta. Luego, entidades locales y nacionales trabajan en conjunto a través de plantas de transferencia, clasificación y valoración de los residuos para optimizar el consumo de energía y preservar los recursos.

En definitiva, Reducir, Reutilizar y Reciclar son tres acciones sencillas, tan fáciles como necesarias. Forman parte de la vida cotidiana y solo demandan pequeños cambios de hábitos. Su práctica se puede llevar a cabo desde el hogar de cada uno y hacerlo de forma generalizada lograría el cambio de mentalidad necesaria para preservar y conservar el medio ambiente."
9/10/2020,Lifestyle,185,55,6,15,261,"Compost, ¡Ya!","Compostar es la manera correcta de desechar residuos orgánicos. Si tiramos una banana o una manzana, por ejemplo, dentro de una bolsa, ésta se va a degradar en años. Si, en cambio, tiramos esos frutos en compost en 30 días se volverá tierra fértil.

Si no queremos que en unos años la basura rellene nuestros mares y nuestros paisajes, tendremos que  aferrarnos a estas costumbres para vivir un futuro más limpio.
El compost es un proceso biológico en el que se crea un ecosistema a partir de desechos orgánicos húmedos como cáscaras de frutas y verduras, o secos como hojas secas de árboles o cartón. Luego, bichos benéficos que nos ayudan a degradar la materia orgánica y convertir el desecho en tierra fértil.

¿Quieres compostar en casa?

Para lograrlo necesitas una compostera,  un poco de tierra  y juntar residuos húmedos y secos. También puede que sea necesario comprar algunas lombrices californianas rojas, que ayudan a acelerar el proceso. Éstas pueden venir junto a la compostera, o se consiguen en algún mercado. La tierra ayudará a los gusanos a vivir.

Desechos húmedos y secos
Entre los residuos húmedos, puedes encontrar cáscara de huevo, restos de frutas y verduras, saquitos de té, café, té en hebras, restos de flores secas o frutos secos. Lo que no deberíamos tirar en compost son los cítricos y la cebolla, porque acidifican el medio y  afectan al proceso de degradación tampoco podemos tirar restos de carnes o harinas.

Los residuos secos son hojas secas de los árboles, fósforos, cartón, papel madera, papel de cocina, papel higiénico. Todos los tipos de papeles que no tengan mucha tinta.

Parámetros a controlar
Humedad: el compost no debe estar ni muy seco ni muy húmedo. Si se encuentra muy húmedo las frutas y verduras se pudrirán y la humedad atraerá mosquitas. Ésto lo podemos corregir agregándole secos. Si está muy seco, no será favorable para las lombrices, habrá que regarlo un poco. Por ello, que es importante que haya una proporción de 50-50 de ambos residuos.

Tip: un colchón de hojas secas  en la parte superior del compost ayudará a mantener su humedad.

Oxígeno: Es importante que el compost reciba oxígeno, por lo que debemos revolver el compost a diario.

Temperatura: a mayores temperaturas el proceso se acelera, mientras que a menores temperaturas se vuelve más lento. Es bueno que al compost le de un poco el sol en el día, pero no de manera constante.

Para realizar compost directamente en la tierra, el proceso consta en hacer un pozo en la tierra y comenzar a tirar nuestros residuos en él. Será necesario encontrar algo para tapar el pozo, para asegurarlo.

Es importante que todos los que podamos nos volvamos a educar en temas ambientales. ¡Compost ya!"
21/02/2020,Lifestyle,193,69,12,18,292,Construir la sostenibilidad desde casa,"Los hogares consumen el 29% de la energía mundial. Además, contribuyen al 21% de las emisiones de CO2 resultantes, según las Naciones Unidas. 

Esto nos deja a todos la responsabilidad de intentar reducir lo máximo posible los consumos en nuestros hogares, para cuidar los recursos, proteger al medio ambiente y a nosotros mismos. 

¿Cómo podemos generar el cambio? ¿Por dónde comenzar? ¿Qué es la arquitectura sostenible? Responde a estas preguntas la arquitecta Natalia Álvarez Bonín. 

¿Cómo afecta la arquitectura no sostenible a la tierra? ¿Cuáles dirías que son las prácticas que hay que cambiar de forma más urgente?

La arquitectura no sostenible contribuye a la contaminación medioambiental debido al uso irracional de energías, la no contextualización de los proyectos ni racionalidad en la elección de materiales. Más urgentemente creo que hay que dejar de proyectar arquitectónica y urbanísticamente sin tener en cuenta el impacto ambiental del proyecto tanto en su etapa de ejecución como luego en su uso.

¿Cuáles son las claves a tener en cuenta para construir de manera sostenible?

Básicamente hay pautas de diseño pasivas tales como la implantación del proyecto, el control del asoleamiento (uso de parasoles, aleros, vegetación), la ventilación cruzada, el uso de materiales térmicamente eficientes, y especialmente el uso de materiales de elaboración local. Luego la incorporación de fuentes propias de generación de energía. Por ejemplo: colectores solares para agua sanitaria y calefacción, paneles solares para energía eléctrica, molinos para extracción de agua si el emplazamiento es suburbano. A su vez, recolectar el agua de lluvia para riego.

¿Qué materiales recomiendas?

Aquellos que dejen la menor huella ecológica (consumo de energía) posible, tanto en su fabricación como luego en su reciclaje. Es importante que los materiales que sean de la zona, o lo más cercanos posibles, tratando así de evitar que haya grandes traslados. También, hay que considerar que los mismos sean duraderos y que tengan un buen comportamiento térmico. Mucho depende del emplazamiento y las características del proyecto; pero en una vivienda trataría de utilizar maderas certificadas, evitar el aluminio y el hierro y utilizar piedras o lajas de zonas cercanas.

¿Qué modificaciones podemos realizar en nuestros hogares no sostenibles?

Lo más fácil es el cambio de la iluminación a iluminación bajo consumo. También se pueden incorporar vegetación o toldos que generen sombra si es que hay fachadas muy asoleadas. En zonas muy frías se puede colocar doble vidriado en ventanas. Si hay equipos de climatización viejos, reemplazarlos por nuevos que sean energéticamente eficientes.

La Asociación Española para la Calidad define la arquitectura sostenible como aquella que tiene tiene en cuenta el impacto que va a tener el edificio durante todo su ciclo de vida. También los recursos que va a utilizar, los consumos de agua y energía de quienes residan y hasta el destino de los residuos una vez se derrumbe. 

Teniendo en cuenta cada uno de los procesos a nivel macro y micro de cada decisión que tomamos y su repercusión en la tierra, es que podemos tomar conciencia y optar por la decisión más saludable. "
9/12/2020,Lifestyle,418,109,3,15,545,Contaminación en femenino,"El pasado 25 de Noviembre, Escocia decretaba una ley para el acceso gratuito a productos
de higiene femenina como compresas y tampones a todas sus habitantes. Lo que antes
sólo era un servicio para estudiantes de secundaria y universidad, ahora, se extiende a toda la población.

El negocio de la higiene femenina, está considerado como: ‘’El gasto invisible’’. Este gasto
continúa desapercibido para muchos gobiernos que no rebajan los impuestos sobre estos productos. Considerado un bien de primera necesidad, son muchas las
personas que no pueden acceder a su compra debido a los altos costes de venta. Es
entonces cuando hablamos de «Pobreza menstrual».

«Se estima que cada mujer gasta alrededor de 1.500 euros en compresas y 2.300 euros en tampones al año» según informa el Diario La Razón.

Organizaciones como INTIMINA o Save a Girl Generation trabajan para que todas las mujeres del mundo tengan el mismo derecho al acceso de estos productos. Pero mientras esta situación llega, el sector de la higiene íntima, empieza a tener firmes competidores. El compromiso por la igualdad y por el medioambiente, hacen que este
negocio empiece a tambalearse notablemente.

La alternativa eco/human-friendly
Alternativas más ecológicas y asequibles empiezan a despuntar en un mercado
que parecía no tener rival. La copa menstrual tiene ya 80 años en el mercado y su venta se ha disparado en Europa en los últimos 5 años. Sus materiales sin plásticos ni pesticidas, y su casi inexistente impacto medioambiental, se sitúa como la opción elegida por muchas mujeres del mundo. Además tiene una duración de 10 años y un coste de alrededor de 30 euros.

Cada año se desechan alrededor de 3.000.000.000 de compresas que tardan en desaparecer en un promedio de 300 años debido al alto porcentaje de plásticos en su composición.
Estas altas tasas de plásticos en las compresas producen en muchas mujeres distintos tipos de alergias o el ya famoso «Shock tóxico». Una compresa contiene alrededor de un 90% de plástico, y un tampón contiene materiales sintéticos como poliéster o polipropileno.

Es por ello que, en los últimos años, también se han promovido numerosos movimientos en
defensa del sangrado libre. O lo que también, se conoce como: ‘’Free Bleeding’’.
Diferentes rostros conocidos, como la maratoniana Kiran Gabdhi o la ilustradora Rupi Kaur, hicieron visible este movimiento durante situaciones de su vida diaria. Psicólogos expertos
en educación menstrual consideran este movimiento como un acto reivindicativo en torno a todo lo que engloba el ciclo menstrual, los efectos sobre la mujer y los tabús que hay
entorno al tema de la menstruación."
13/03/2020,Lifestyle,514,124,0,3,641,Coronavirus: seguridad alimentaria para prevenirlo,"Las buenas prácticas de manipulación son una herramienta esencial para obtener productos inocuos para el consumo humano. Cada vez que manipulemos alimentos debemos cumplir con ciertas pautas para que al consumirlos se encuentren en buena calidad, libres de virus y microorganismos patógenos.

A diferencia de las bacterias, que son microorganismos vivos, los virus son pequeños pedazos de ADN o ARN encapsulados que únicamente se multiplican dentro de células de otros organismos. Esto significa que solamente son capaces de reproducirse de esta manera, porque carecen de una maquinaria de replicación celular. Básicamente lo que hacen es «secuestrar» la fabrica de la célula para multiplicarse.

El coronavirus es un virus que afecta directamente a las vías respiratorias.

Además de los cuidados detallados por la Organización mundial de la Salud, como lavarnos adecuadamente las manos y no tocarnos la cara, entre otros; es importante considerar ciertas cuestiones de seguridad alimentaria para prevenir esta enfermedad.

Todo aquello que compremos en el supermercado y llevemos a nuestros hogares debemos lavarlo con abundante agua – en lo posible caliente – y tomar algunas precauciones extra. A continuación, algunos consejos:

• Tener una buena higiene de manos. El lavado debe durar lo que dura la
canción de feliz cumpleaños. El alcohol en gel no reemplaza el jabón. Es importante lavarnos las manos frecuentemente con agua y jabón.
• Evitar la contaminación cruzada, cortando los vegetales en una tabla y la
carne en otra.
• Cocinar bien los alimentos. Deben llegar a una temperatura mínima de 70º C en el centro. Evitar los alimentos crudos.
• Lavar los huevos siempre antes de cocinarlos.
• Conservar alimentos cocidos en la nevera. Nunca dejarlos en temperatura ambiente.
• Lavar adecuadamente frutas y verduras utilizando unas gotas de vinagre o lavandina de uso alimenticio.
• Conservar siempre los alimentos fuera del alcance de insectos, roedores
o animales de compañía."
15/07/2021,Lifestyle,265,118,26,6,415,Criptomonedas: la nueva economía contaminante,"Un éxito digital que daña al planeta
Desde su aparición en 2007, el sistema de las criptomonedas ha ganado relevancia en el mercado digital. Pero lo que no se cuenta sobre ellas es que son la nueva economía contaminante.

Desde su obtención hasta su uso, las criptomonedas y las prácticas utilizadas para su empleo requieren de un fuerte consumo energético, dejando importantes daños medioambientales.

La creación de criptomonedas se obtiene a partir de minados. Para obtenerlas, también se utilizan combustibles fósiles y la actividad en centrales energéticas. Esto deja cantidades próximas a 23 megatoneladas anuales en huella de carbono y unas emisiones de CO2 equivalentes a lo que podría producir una ciudad como Las Vegas. Es por ello que países como Irán ya han prohibido las prácticas de minado, dedicadas a la obtención de criptomonedas. 

Por otro lado, el uso de grandes computadoras para llevar a cabo las transacciones de criptomonedas deja elevadas cantidades de consumo energético. Un estudio realizado por el Centro de Finanzas Alternativas de la Universidad de Cambridge, afirma que la cantidad de consumo energético que dejan estos sistemas es de 174 teravatios/hora. Un consumo muy por encima del de países como Argentina, Chile, Suiza o Bolivia:

Argentina: 120 teravatios/hora. 
Chile: 74 teravatios/hora.
Suiza: 56 teravatios/hora 
Bolivia: Apenas 9 teravatios/hora. 
Ante la gravedad de la situación, numerosas empresas norteamericanas han dejado de aceptar pagos con esta divisa con el fin de proteger el medioambiente. Y empiezan a surgir las primeras en poner en marcha planes de desarrollo sostenible para frenar la problemática que genera el uso de criptomonedas. 

Criptomonedas y sostenibilidad
«Se debe invertir en sistemas más eficientes de minado. Se necesitan medidas urgentes en los sistemas de transacción de la divisa para poder progresar hacia una tendencia sostenible»- Así lo informa Mario Arcusso, responsable de Desarrollo de Negocio de North Pole en declaraciones al medio Europa Press.

Ethereum, firme competidora de Bitcoin, ya se posiciona como la primera empresa sostenible de criptomonedas. Sus planes de desarrollo permitirían rebajar el consumo energético que deja el sector hasta un 99,5%.

Por lo que hace a los expertos, no apoyan la sostenibilidad en el sector, ya que esto supondría modificar aspectos clave del funcionamiento y seguridad de la divisa. Y con ello, rebajar también su valor. "
20/01/2020,Lifestyle,61,9,0,6,76,"Crossfit: ¿Qué es, qué beneficios brinda?","Es la actividad deportiva por excelencia de los últimos años. Nació en 1995 de la mano de Greg Glassman, pero llegó a España y América Latina pisando fuerte alrededor del 2010. 

¿Por qué se ha vuelto tan popular? Actualmente hay centros puramente especializados en esta disciplina y la respuesta probablemente se deba a que se trata de un nuevo tipo de ejercicio. Pero más importante aún, promete resultados visibles en poco tiempo. 

El Crossfit fue el puntapié de las actividades más lúdicas y de las jornadas de gym de 45 minutos en vez de 1 hora en los que se alternan períodos de esfuerzos de alta intensidad con otros de descanso. Este ejercicio consiste en realizar movimientos o actividades que normalmente realizamos, sin percibirlo, en la vida cotidiana. Por ejemplo, saltar, empujar, arrastrar, levantar. La clave se encuentra en que a estas actividades, les suma peso. Así es como el Crossfit nos permite ganar en resistencia, equilibrio y flexibilidad.

Los ejercicios persiguen dos objetivos:

Aumentar la masa muscular
Aumentar la capacidad aeróbica.
Miriam Machengo, especialista en medicina estética y nutrición recomienda 2 puntos a tener en cuenta:

Principio de no violencia. “Cada cuerpo tiene su ritmo, y esto significa que hay que ejercitarlo paulatinamente para lograr lo que nos proponemos, sin violentarlo, ni lastimarlo. El esfuerzo debe ser adecuado a la condición física de la persona. El peso que se utilice en cada ejercicio, también”.
Principio de no competitividad. “Hay muchos “modelos” fit en las redes. Pero es importante que cada uno de nosotros trabaje con su propia marca, su propio desafío”."
23/01/2020,Lifestyle,217,59,6,24,306,"Cuerpo, mente y espíritu en sintonía en el siglo XXI, ¿Es posible?","El Ashtangs Vinyasa Yoga es una práctica que forma parte de un estilo de vida alineado con una filosofía de vida en calma, en la que mente y cuerpo se encuentran en sintonía. 

Este yoga ancestral una danza continua que contiene varias series en la que la primera nos prepara para la siguiente. Movimiento en sincronía, respiración, punto de fijación visual y cierres energéticos: de esto se trata este tipo de yoga. 

Los tiempos de la vida moderna nos llevan a actuar sin pensar, a seguir andando sin detenerse, por que quien lo hace, en teoría, pierde. Ya son muchos quienes buscan aunque sea un par de horas a la semana, volver a conectar consigo mismos. Se trata tal vez, de recuperar o reencontrarse con la energía que depositamos en cada acción que realizamos.

¿Y por qué realizando ejercicio físico? Porque lo físico se transforma inevitablemente en fuerza de voluntad y en equilibrio emocional. Al trabajar el cuerpo, estamos también trabajando ambos hemisferios cerebrales. Además, la flexibilidad de nuestras articulaciones se traducen en flexibilidad mental. 

En los Himalayas nació el Ashtangs Vinyasa Yoga. Aunque se desconoce el momento exacto de su creación, sí es seguro que se trata de una práctica ancestral, popularizada en el siglo XX de la mano de Sri K. Pattabhi Jois.

El Vinyasa hace referencia a la sincronía entre el ejercicio y la respiración entre cada una de las posturas, o asanas, como son llamadas. Todo se trata de la respiración, que en este yoga es fuerte y profunda. Al regularla, también se trabaja sobre la circulación sanguínea. A medida que el respiro se vuelve más rítmico en la práctica, el cuerpo se alinea y la mente se calma. 

Según los especialistas, mientras mayor es la sudoración, más profunda es la limpieza de nuestro cuerpo, debido a las toxinas que se eliminan a través de la piel. Los maestros aconsejan no secar el sudor durante la práctica, para que permitir la reabsorción de las sales minerales."
25/08/2021,Lifestyle,657,109,44,15,825,Desertificación en Málaga por el cultivo de aguacates,"Un cambio climático sin precedentes y un regadío mal gestionado están dejando a Málaga inmersa en profundas sequías, hecho que conlleva la pérdida de numerosos campos de cultivo. Se está generando una desertificación en Málaga por el cultivo de aguacates.

La comarca de Axarquía es la más afectada por las sequías acontecidas en los últimos años. Se estima que las reservas hídricas del lugar pueden cubrir apenas el 25% del regadío que este manjar necesita. José Ricardo Campos, presidente de la Junta Central de Usuarios del Sur del Guaro, advierte de la gravedad por la que atraviesa el lugar y ya ha anunciado cortes de suministro en algunos lugares de cultivo.

“El que no tenga agua en agosto y septiembre se ha despedido del aguacate y del árbol puede ser que también” -Campos en declaraciones al Diario El Mundo.
El árbol del aguacate es una especie nativa de países subtropicales y precisa de abundantes periodos de lluvias para su producción. La escasez de precipitaciones y las temperaturas cálidas hacen que el cultivo en el sur de España se complique. Se necesitan unos 1.000 litros de agua para cultivar un kilo de aguacates, lo que conlleva a la comarca andaluza a usar hasta 14,12hm3 más de los permitidos para los riegos del árbol del aguacate.

Ya en 2009, la situación de la comarca se puso en conocimiento cuando se detectó una mala calidad en diversos ríos de la zona. El motivo eran las excesivas extracciones de agua para abastecer el riego de los árboles. Organizaciones ecologistas como Ecologistas en Acción hablan ya de ‘‘colapso hídrico’’ si no se toman medidas urgentes ante la situación que se viene dando en los últimos años. 

Desde el CSIC, se aboga por una plantación más dispersa y que pueda cumplir con los recursos hídricos del lugar. Por otro lado, la Junta de Andalucía trabaja desde el 2020 en un plan sostenible que ayuda a los lugares productores de plantaciones subtropicales y que están gravemente afectados por la escasez de recursos hídricos. La instalación de dotaciones reducidas de agua promovería la productividad de las aguas del territorio.

¿Falta de recursos hídricos o excesiva demanda?
Se estima que el consumo de aguacate crezca en los últimos años entre 3 y 5 puntos respecto a años anteriores, lo que confirma una mayor demanda de este manjar considerado ya como ‘‘oro verde’’. 

Según la Organización Mundial del Aguacate (WAO), en 2018 sólo en España, se consumieron 74 millones de toneladas, y aunque el país no está considerado como uno de los mayores consumidores del mundo, lo cierto es que su consumo podría incrementarse hasta los 84 millones de toneladas al año.

Expertos nutricionistas, recomiendan hacer un consumo responsable de este manjar. Ya que un exceso de consumo puede conllevar a daños en el organismo. Se recomienda comer cada día una quinta parte del aguacate, lo que equivaldría a 30 gramos. "
22/09/2020,Lifestyle,121,88,0,214,423,Disney: diversión sostenible,"Cada vez son más las grandes empresas que buscan dar respuesta a las exigencias de los ahora “más concientizados” consumidores. Aquello que antes consumíamos sin cuestionamientos, ahora es sometido a un test sostenible. Ahora es el turno de Disney. La empresa de entretenimiento ya cuenta con un programa de desarrollo de sostenibilidad para diferentes unidades de negocio.

En cuanto a los parques temáticos, el cambio que se aproxima es igual de importante, como lo es de dificultoso. Es que la actividad prácticamente no cesa. Cada uno de los parques cuenta con programas para minimizar los impactos negativos en el medio ambiente. 

Animal Kingdom es uno de los parques en los que mejor se visualiza este nuevo compromiso asumido. Este parque, ubicado en Florida, trabaja para la conservación de especies y ecosistemas. Siendo un parque dedicado a ésta temática, persigue concientizar a los visitantes de la importancia del cuidado medioambiental. 


Desviar el 60% de sus residuos de los vertederos, reducir los consumos de agua en todos los aspectos y reducir las emisiones netas en hasta un 50%. Estos son los tres grandes objetivos que propone Angie Renner, directora de Integración Ambiental en Walt Disney World Resort.
Energía solar: la mayor apuesta
Disney, no solo trabaja para la conservación del ambiente y en la creación de espacios sostenibles. También, posee proyectos relacionados con la energía solar y sus usos. Su primer gran proyecto se hizo con la matriz solar ‘’Mickey’’ ubicada cerca del parque Epcot con 22 hectáreas de terreno. Este conjunto de placas solares, desde 2016, es la encargada de impulsar algunas atracciones del parque Walt Disney World. 

Otro de sus proyectos de energía solar, es un panel ubicado cerca del parque Animal Kingdom, capaz de abastecer a dos de sus cuatro parques. Digamos que, esta placa, podría generar energía para unas 10.000 casas.

¿Más ejemplos de su compromiso con la diversión sostenible?
Los transportes proporcionados por la compañía para el traslado de sus visitantes, fueron la primera flota de autobuses en utilizar combustible renovable. Concretamente, diesel renovable R50. Este, es creado a partir de aceite de cocina usado y desperdicios de alimentos no consumibles.
Para la iluminación de sus castillos en periodos navideños, estos contienen luces de LED. Estas luces, proporcionan la luz suficiente para llevar a cabo esta función dentro del parque, sin desperdiciar más consumo energético del necesario.
El sistema de riego de los jardines se efectúa con agua recuperada.
Disney cuenta con equipos acreditados para la conservación de especies en peligros de extinción. Cuenta con unos 1.500 mamíferos, aves y reptiles. Y más de 5.000 especies de peces.
El fondo de conservación Disney Worldwide, apoya la investigación científica. Incluyendo entre los años 2016 y 2017, un programa de becas, dedicados a la investigación de conservación de ecosistemas.
En el año 2019, todos sus parques habían eliminado de sus servicios de hostelería, los utensilios de plásticos y derivados de estos."
4/09/2020,Lifestyle,232,39,9,47,327,Educación ambiental: la asignatura pendiente de las escuelas,"Septiembre, en muchos lugares de Europa, es sinónimo de comienzo del nuevo curso escolar. Con ello, los pequeños de cada casa, se enfrentan a nuevos retos y nuevas asignaturas. Pero muchos colegios se olvidan de una: La Educación Medioambiental.

Un estudio de la Universidad de Stanford comprobó cómo esta asignatura es capaz de beneficiar a niños desde edades muy tempranas. Tanto es así que, este estudio, concluye: Hasta un 83% de los niños, que imparten educación medioambiental en las escuelas, son capaces de tener un mejor rendimiento en asignaturas como matemáticas y ciencias. Además, de mejorar su comportamiento con el medio ambiente. Países como Francia o Dinamarca, ya cuentan con planes de estudios ambientales en sus temarios escolares.

Lucía y Rubén son una pareja de publicistas españoles y creadores del blog Algo que recordar, una serie de relatos en primera persona que, entre otras cosas, educa sobre consciencia ambiental. Ambos dejaron sus trabajos para avocarse de lleno a viajar. Con la llegada de su hijo Koke, crearon el documental Hola Mundo, en el que cuentan la importancia de criar a niños libres y felices, en conexión con la naturaleza.


El ejemplo de Lucía y Rubén es uno de los muchos que podemos encontrarnos. Pero en Econews Today, te lo ponemos fácil. A continuación, te daremos algunos consejos para que, desde tu casa, enseñes a tus pequeños a tener cuidado del medioambiente:

Cualquier acción, conviértela en un juego. Reciclar es un buen recurso para ello. La variedad de colores de cada contenedor, y explicarles por qué se deben separar materiales, es una acción entretenida para los pequeños.
Acostumbrarlos a ahorrar en el consumo de luz y agua. Con ello aprenderán que, estos recursos, generan impactos negativos en el medioambiente si se malgastan. A la vez que, es un bien escaso en muchos lugares. Con ello, también, enseñamos la importancia de utilizar únicamente lo necesario para cada situación.
Enseñarles a cuidar y respetar todo aquello que forma parte del medioambiente, como por ejemplo, las plantas. Las plantas son seres que precisan cuidados. Se puede educarlos en cómo regarlas y cuidarlas, para que no mueran. Este es un método de concienciación para que los pequeños respeten todo lo que nos envuelve y también, tener hábitos de constancia y cuidado de elementos esenciales para el medioambiente.
Potencia el hábito de compartir. Con ello, enseñamos a los pequeños a prestar aquello que es suyo. Así cuando no usen los juguetes, pueden darlos a otros niños sin necesidad de tener que tirarlos y generar más gases contaminantes durante el proceso de desecho."
31/12/2019,Lifestyle,88,62,64,0,214,El ABC del reciclaje,"Las políticas de reciclaje pueden depender de cada ciudad.
Pero, ¿Qué podemos tener todos en cuenta para colaborar en reducir la energía que se gasta en producir envases nuevos y el desperdicio en general?
A continuación, una guía básica para iniciarse en el cuidado del planeta:

Envases de plástico

Todo tipo de botellas, contenedores, baldes, vasos, bolsas, utensilios de plástico, juguetes (que sean completamente de plástico), perchas, bandejas de comida rápida. 
-No debemos incluir recipientes sucios, ni aquellos que hayan contenido aceite de cualquier tipo o sustancias tóxicas-.

Envases de cartón y papel

Periódicos, revistas, papel corrugado, cajas de cartón, bolsas de papel con o sin interior de plástico, sobres, e incluso libros viejos.
¿Qué debemos tener en cuenta? Quitar las otras partes que puedan contener aquello que estamos desechando que no sea papel, por ejemplo, una cuerda de metal. 
-Las fotografías y servilletas usadas no se reciclan-.

Envases metálicos

Latas de aluminio, acero, bandejas, ollas, sartenes, latas de aerosol vacías.
Es importante consultar en tu municipio dónde depositar los residuos de mayor tamaño como muebles de metal.

Envases de vidrio

Todo tipo de botellas, jarras, vasos, bandejas, envases de mermeladas.
Tip: Antes de desecharlas, te sugerimos probar darles un nuevo uso. Con botellas y envases de mermelada puedes crear floreros, jarrones, lámparas originales y mucho más.

Desechos orgánicos y residuos biodegradables

Todos los desechos de origen vegetal o animal pueden reciclarse muy fácilmente. Restos de comida que consumimos diariamente, huesos, pequeños restos de poda, servilletas o manteles de papel que no estén limpios, corcho natural, bolsitas de infusiones.

Otros residuos

Todos aquellos residuos que no sean envases, o que no tengan un sistema específico de recogida en tu municipio, por ejemplo una sartén rota o  juguetes que contengan distintos materiales, deberás depositarlos en el contenedor de resto de residuos.

Bonus tips

Antes de desechar tus residuos orgánicos, prueba utilizarlos como fertilizantes naturales para tu huerta o jardín. 
¿No sabes qué hacer con los esmaltes de uñas? Vierte todo su contenido y enjuágalo. Luego, deposita su envase en el contenedor de envases de vidrio. 
El aceite usado de cocina suele ir directo al sumidero, lo cual no sólo dificulta su reciclaje, si no que además daña el medioambiente ya que acaba en ríos y océanos. Para reciclarlo correctamente, debemos guardarlo en envases de vidrio y depositarlo en el sitio específico de nuestra ciudad."
15/06/2021,Lifestyle,491,100,24,9,624,El agua gratis en España no es una posibilidad,"Aunque en otros países brindar agua gratis en bares y restaurantes a los clientes es una práctica frecuente; en España resulta complicado por la contaminación. Lo cierto es que para llevar a cabo esto, se debería trabajar conjuntamente con Administraciones Públicas para verificar que la calidad de las aguas sea apta para el consumo.

Burgos, San Sebastián y Las Palmas de Gran Canaria, son las ciudades que podrían ofrecer agua gratis en España, por su gran calidad. Ciudad Real, Palma de Mallorca y Barcelona en cambio no cuentan con agua de buena calidad como para ser consumidas.

La contaminación es la razón para no ofrecer agua de forma gratuita
Greenpeace advierte que el país no presenta medidas eficaces para hacer frente al problema de la contaminación medioambiental. Las altas tasas de contaminación que se registran repercuten en diversos ámbitos, uno de ellos, es en la calidad de las aguas.

Si España quisiera ofrecer una excelencia de sus aguas en toda sus Comunidades Autónomas por igual, debería trabajar en 3 grandes cuestiones que son:  

Trazar planes de actuación contra la contaminación por nitratos.
Exigir la defensa de agua limpia. Lo que supone una legislación sobre la actividad en granjas industriales.
Hacer visible la grave situación por la que pasan los recursos hídricos, y darle más relevancia así, a la calidad de sus aguas.
Una de las alternativas más eficaces contra la contaminación por plásticos, sería implantar sistemas de depósito y retorno. Este sistema, ya ha registrado altas tasas de eficacia en países como Alemania con resultados del 98% de eficacia. 

La falta de precipitaciones, problemas en la depuración y determinados métodos de extracción, son algunos de los factores que influyen en la calidad de las aguas, según informa RTVE.

Existe un Anteproyecto de Ley cuyo objetivo está en reducir aquellos plásticos dedicados a la comercialización de aguas y bebidas embotelladas, que resulta ser uno de los grandes factores contaminantes. Es por ello que, ofrecer agua gratis en bares y restaurantes cobra fuerza. Los expertos, le atribuyen carencias a este Anteproyecto, ya que no presenta alternativas de actuación. Y se olvidan del problema principal: el cambio climático. Ante esta situación, se pide actuar sobre el problema, y no tanto, en las consecuencias. Por lo que recurrir a recursos hídricos para minimizar los niveles de contaminación, no sería la solución."
13/11/2020,Lifestyle,247,106,9,9,371,El arte de emprender sano,"Con la pandemia, muchas personas no sólo se han visto obligadas a modificar sus rutinas, sino también a reinventarse laboralmente. Se estima que en España, ha crecido hasta un 63% el número de emprendedores a pesar de la pandemia. Así lo informa el VII Mapa de emprendimiento creado por South Summit.

Y es que, ‘’En teoría, todo es práctica’’. Así es como, Maica, una joven catalana de 29 años emprendió su pequeño negocio de creación de objetos decorativos y abalorios. Un negocio totalmente comprometido con el medioambiente. Y basado en el ‘’ARTE-SANO’’.

¿Qué te llevó a emprender ‘’Sonrieeme’’?

Una de las mayores motivaciones han sido mis ganas de poder desarrollar mi creatividad haciendo algo que me gusta, poder crear, cambiar la forma física de la materia prima. Pero la falta de tiempo, nuestra manera casi automática de vivir, no me permitía poder prestarle toda la atención necesaria al proyecto y poder materializarlo. 

Pero a raíz de la situación actual, como ya sabéis todos, llegó el confinamiento y yo vi la oportunidad perfecta para ponerme con ello. Sentía que era todo un reto comenzar un proyecto en mitad de una pandemia mundial, pero por otro lado era un «ahora o nunca». 

¿Cómo es el proceso de creación y elaboración de los productos en Sonrieeme?

 Siempre he estado muy concienciada con el medio ambiente y desde un principio he tenido claro que todo sería creado y elaborado de manera sostenible creando el mínimo impacto, y usando la regla de «Las tres erres» casi por ley.

Utilizo para la fabricación de cualquiera de los productos maderas procedentes de bosques sostenibles con certificación FSC. Todo se crea de manera manual, donde no se requiere el uso de tecnología avanzada, sino de máquinas y herramientas manuales. Produciendo productos personalizados a mano y no en cadena para que todo el conjunto sea sostenible ya que no necesita grandes fábricas y el impacto ambiental es mínimo. 

Lo elaboras todo sola, eso debe ser un desafío. Pero…¿Algún reto creativo que tengas a corto plazo?

Lo hago todo sola, pero tengo la suerte de poder contar con personas maravillosas que me ayudan en todo lo que necesito. Realmente no tengo ningún reto a corto plazo, mi reto es disfrutar día a día de lo que estoy haciendo cómo lo hago ahora. A largo plazo bromeo con hacerle la competencia a Ikea.

¿Por qué crees que la gente debería empezar a invertir más en arte sostenible?

Creo que como consumidores tenemos más poder del que pensamos y decidir invertir en arte sostenible siempre es un acierto. Con nuestro consumo podemos recompensar modelos productivos, justos y sostenibles, apoyar al pequeño comercio, emprendedores, el consumo local y todo este conjunto tiene beneficios ambientales, sociales y económicos. Creo que nuestras decisiones en el presente en cuanto consumo, y en general, repercutirán en los modos de vida humanos en un futuro y cada vez somos más personas conscientes de ello, por suerte. 

¿Dónde y cómo puede la gente encontrarte y adquirir alguno de tus productos?

Podéis encontrarme por redes sociales tanto por Instagram @sonrieeme, como por Facebook. En breves intentaré tener lista la web. O si lo preferís, me escribís, y estáis invitados un día a venir al tallercito y ver como se hace todo de primera mano. Eso sí, traed café."
15/10/2021,Lifestyle,91,15,0,0,106,El teletrabajo reduce la contaminación,"Aumentar el teletrabajo reduce la contaminación hasta un 10%, según un informe del Institut de Ciència i Tecnologia Ambientals (ICTA-UAB). Este compara los datos de movilidad y la calidad del aire con la implementación del teletrabajo en Barcelona durante el confinamiento. 

Se puede considerar que el año pasado fue bastante atípico. No solo la gente debía trabajar desde su casas, nadie podía salir. Las calles vacías, ni coches, ni autobuses, ni trenes, parecía que el mundo se había detenido. Según la Agencia Internacional de Energía, la actividad media mundial de las carreteras durante el 2020 cayó casi un 50% en comparación con 2019. Claramente, como consecuencia, la contaminación del aire disminuyó.

El teletrabajo reduce la contaminación de dióxido de nitrógeno
Ahora bien, ¿Qué se puede tomar de esta experiencia a día de hoy? Implantar un sistema de teletrabajo de dos, tres y cuatro días a la semana permitiría reducir los niveles de dióxido de nitrógeno (NO2). Este, según el estudio del ICTA-UAB, es el principal contaminante relacionado con las emisiones de tráfico. 

Cabe aclarar que los niveles elevados de NO2 pueden irritar los pulmones y disminuir la función pulmonar, además de reducir la resistencia a infecciones respiratorias. Según el MITECO, los efectos de respirar este gas continuamente puede producir inflamación en las vías respiratorias, entre otras cosas. 

Trabajar desde casa 4 días a la semana disminuiría un 10% la contaminación del aire
Para contextualizar, un 85% de los habitantes de Barcelona se dedica al sector de servicios y casi el 40% del tráfico de vehículos personales está relacionado con el trabajo.

En el estudio del ICTA se plantearon tres escenarios posibles, partiendo de una jornada laboral de 5 días a la semana. En el primero, se propone trabajar desde casa 2 días de la semana. Esto permitiría reducir las emisiones relacionadas con el tráfico en un 5%, y los niveles de NO2 en un 4%. En el segundo, serían tres días de teletrabajo, que reduciría las emisiones en un 10% y los niveles de NO2 en un 8%. Por último, el tercer escenario serían 4 días de teletrabajo y las emisiones de tráfico se reducirían un 15% y un 10% los niveles de NO2. En este último caso, se reducirían casi un 38% los desplazamientos. 

No hace falta explicar que no todos los trabajos pueden hacerse desde nuestros hogares. Al igual que somos seres sociales, estar en la oficina puede afianzar y generar más vínculos entre los compañeros. La existencia de estos estudios que demuestran el cambio que puede hacer el teletrabajo a nuestro planeta es una forma de incentivar a las empresas a dar el paso e implementarlo más en la jornada laboral. "
10/12/2019,Lifestyle,211,62,3,12,288,Endulzar natural y sin calorías,"Hay tantas opciones en el mercado, que puede hacerse difícil elegir. 

Júlia Farré, dietista-nutricionista del Centro de Nutrición Júlia Farré, nos cuenta cómo pararnos frente a la góndola y tomar una decisión saludable para nuestro cuerpo.
“Los endulzantes naturales son productos no sintetizados artificialmente” explica Farré, concepto que el movimiento real food abraza perfectamente. Los principales son: azúcar en forma de sacrosa o fructosa, miel, stevia, Iuo han guo y taumatina.

¿Cuáles son las características de cada uno?

Azúcar -sacarosa o fructosa-
Se trata de dos tipos de azúcares que se encuentran de forma natural en muchas verduras y frutas. La sacarosa conoce comúnmente como azúcar de mesa y puede obtenerse tanto de la caña de azúcar como de la remolacha azucarera.

Miel
Es generalmente la opción menos elegida ya que aporta calorías. Contiene gran cantidad de azúcares simples, mayoritariamente en forma de fructosa.

Stevia
Se popularizó estos últimos años en europa y américa latina. Es de origen vegetal, no aporta calorías y puede beneficiar a personas con diabetes. Aun así, Farré explica que  “todavía no está claro cómo puede llegar a afectar nuestra microbiota intestinal” y es por ello que recomendamos su consumo controlado.

Luo han guo
Este derivado de una planta que crece en China, está cobrando fuerza entre los real fooders, aunque todavía es difícil encontrarlo en todos los supermercados. Aunque aporta carbohidratos su uso como endulzante hace que sea bajo en calorías.

Taumatina
Proviene de una planta de África Occidental y es mucho, mucho, más dulce que el azúcar, se estima que entre unas 1600 a 3000 veces más. A su favor, al ser tan endulzante, se utiliza en pequeñísimas cantidades y por ende representa una cantidad de calorías mínima.

Sea cual sea la forma de edulcorar que elijamos, resulta fundamental que su origen sea ecológico, ya que contribuímos en cuidar a la tierra y también a nuestro organismo.

“No recomiendo el consumo habitual de ninguno de ellos. Tenemos que educar nuestro paladar al sabor natural de los alimentos. Si estamos habituados a consumirlo, lo ideal es empezar su reducción poco a poco con la finalidad de eliminar su consumo” resume la nutricionista."
17/02/2020,Lifestyle,302,117,3,3,425,Frutas de estación; ¿Cuáles son y por qué consumirlas?,"Las frutas de temporada son aquellas que crecen de manera natural, es decir, con su ciclo dictado por la tierra. Cuando encontramos en los supermercados o verdurerías frutas que no son de estación, se debe a que fueron producidas en condiciones artificiales. Éstas crecieron en microclimas y son menos beneficiosas para el planeta, y para nuestra salud. 

¿Alguna vez te has preguntado por qué la natrualeza ofrece ciertas frutas y verduras en una época determinada del año?

En verano crecen melones, sandías, cerezas y peras, entre otras. En esta estación, nuestro cuerpo requiere de alimentos que contengan gran cantidad de agua y estas frutas son ideales para ello. El melón y el mango, por ejemplo, contienen además betacaronetos que protegen la piel del sol.

En invierno crecen en mejores condiciones los cítricos. Naranja, limón, pomelo, mandarinas y kiwis son nuestros aliados en esta estación, en la que necesitamos una mayor dosis de vitamina C para reforzar el sistema inmunitario.

¿Por qué consumir las frutas en su momento dictado naturalmente? Aquí, algunos motivos: 

Son más nutritivas ya que maduran naturalmente. Por ello, suelen tener mayor contenido de antioxidantes, vitaminas, minerales y nutrientes esenciales. 
Son más sabrosas al ser alimentos frescos. Conservan su textura y sabor natural ya que son recolectados en su punto óptimo de maduración.
Son mas sustentables. Su producción requiere menos energía y genera una menor cantidad de emisiones de dióxido de carbono. Al ser de producción local, no necesitan recorrer miles de kilómetros hasta llegar a nuestro plato. 
Cuidan la tierra. Al consumir las frutas de estación, se evita la implantación de monocultivos y fertilizantes que agotan y dañan la tierra.
Lo cierto es que la naturaleza es sabia y nos brinda aquello que necesitamos para que nuestro organismo se encuentre en óptimas condiciones según la estación en la que nos encontremos."
22/01/2020,Lifestyle,238,70,3,6,317,Granola: ¿Buena para la salud?,"¿Qué es la granola? Se ha vuelto muy popular estos últimos años. Te contamos la verdad sobre este alimento.

Se trata de una mezcla de granos grandes, como almendras, nueces, avellanas; medianos como semillas de zapallo y girasol, y pequeños; semillas de chía, lino y amapola. En algunos casos también contiene fruta deshidratada.
Pero esta combinación posible de ingredientes que se hornea, es el mejor escenario posible.

Según cuenta la Dra. Miriam Manchego; Especialista en Oftalmología, Medicina estética y Nutrición, en ocasiones puede contener avena, arroz, pasas de uva, o endulzantes con una carga de azúcares alta. “Cuando los alimentos contienen conservantes, saborizantes y colorantes, alteran la calidad nutricional y además, son inflamatorios”.
Es por ello, que la doctora recomienda la granola “en sus versiones paleo o reales: de origen casero, orgánico, sin pesticidas ni cargas de azúcares”.

¿Es beneficiosa para la salud? ¡Sí!

Es rica en grasas saludables.
Reduce el colesterol.
Contiene vitaminas minerales, antioxidantes.
Favorece la salud intestinal por su fibra alimentaria.
Es rica en nutrientes, materia prima para nuestros órganos vitales.
Se relaciona con la reducción de enfermedades inflamatorias crónicas como cáncer, diabetes, enfermedades respiratorias y neurodegenerativas entre otras.
¿Qué debemos tener en cuenta a la hora de consumirla? La Doctora nos brinda 3 consejos:

Elegir prioritariamente las preparaciones caseras, con ingredientes orgánicos libres de pesticidas.

Acompañarla de productos fermentados como el kéfir o yogurt natural, que aporta excelentes bacterias para la función intestinal.

Consumirla como un snack, no como base en la alimentación."
5/07/2021,Lifestyle,328,115,58,9,510,Huerto urbano casero: las 5W de cultivar en casa,"Tener un huerto urbano casero se vuelve cada vez más popular. No importa si no tienes un terreno para hacerlo, puedes aprovechar al máximo los espacios de tu hogar. Cultivar tu propia comida, saber qué y cómo consumimos se vuelve una prioridad.

La sostenibilidad no es una moda, ha llegado para quedarse. Atraviesa desde las políticas públicas y privadas hasta nuestra forma de comer. La cultura de los huertos urbanos caseros se ha ido desplegando tanto en países desarrollados como en países en vías de desarrollo por necesidad.

(Cómo y Dónde) Los huertos urbanos caseros suelen ser de madera o puedes utilizar las macetas que tengas a tu alcance
El método más popular últimamente es el del cajón de madera. Se venden en varios sitios, hasta hay tutoriales en Youtube de cómo hacerlos tú mismo. Básicamente sirve de recipiente para la huerta. También hay bolsas de cultivo, las cuales son como macetas de tela, más fáciles de transportar y de amoldarse al entorno. 

La realidad es que el espacio que tienes en tu casa es lo que determinará cómo y dónde plantar tu futura comida. Por otro lado, las clásicas macetas son perfectas para sitios reducidos.

El tiempo y la luz son factores que no hay que olvidar. Demanda tiempo y constancia cuidar de otro ser vivo. Hay que tenerlo en cuenta a la hora de decidir qué sembrar y en qué cantidad.

(Qué y Cuándo) El consumo de frutas y verduras de temporada asegura mayor sabor
La comida de estación impulsa a respetar el ciclo natural de producción. Además, es más ecológica y respetuosa con el medio ambiente, según Sostenibilidad para todos. Al ser de temporada, no es necesario el uso de pesticidas o conservantes, su cultivo no es forzado. No debe aguantar en cámaras que le restan sabor y nutrientes. 

Cada planta tiene su época de siembra. Por ejemplo, en la temporada de verano se recomienda plantar fresas, frambuesas, tomates, lechuga, zanahoria, calabacín, berenjena y pimiento, entre otras. Desde Ecoinventos, se aconseja comenzar con cultivos fáciles, que sean de ciclos cortos, no vulnerables a plagas y enfermedades y de fácil manejo. 

(Por qué) La huella de carbono se reduce si nos abastecemos con productos locales
Tan locales que no hace falta ni salir de casa. No tienes que transportarte para ir a la tienda, así disminuyen las emisiones de CO2. Tener un huerto urbano estimula hábitos alimenticios más saludables y mejora la salud, como recomiendan los ODS (Objetivos de Desarrollo Sostenible).  

Por otro lado, cultivar en casa tiene también un fin terapéutico, asimismo, ayuda a entender, valorar y respetar la naturaleza. No es casualidad que cada vez se fomente más en las escuelas y se lo considere una herramienta educativa transformadora por el Centro Nacional de Educación Ambiental.

En conclusión, para empezar hay que invertir un poco de dinero en materiales y semillas, aun así, se amortiza muy rápido. La satisfacción de cultivar en casa y tener comida saludable al alcance de tu mano no tiene precio."
29/10/2021,Lifestyle,87,20,0,5,112,La batería de diamante radiactiva que dura 28.000 años,"¿Te imaginas una batería que dure para siempre? La startup de Estados Unidos NDB, que significa “nano diamond battery”, está desarrollando una batería de diamante hecha a partir de desechos nucleares que asegura durar 28.000 años. 

Para fabricar la batería, la empresa utiliza isótopos radiactivos, que son átomos capaces de emitir energía en forma de radiación junto con un diamante que absorbe energía de los isótopos. Al tener estos varios miles de años de vida útil, los creadores afirman que seguirán produciendo energía y no hará falta recargar la batería nunca. 

Batería de diamante: dos beneficios en uno
Estas baterías traerán un beneficio ambiental, ya que para su fabricación se reutilizarán desechos radiactivos.

Hasta el momento, estos desechos han estado acumulados en plantas nucleares. Su eliminación y almacenamiento siempre ha supuesto un problema dado que persisten en el medio ambiente debido a su larga descomposición. Estos son altamente peligrosos para la salud humana y para el medio ambiente. Reciclarlos reducirá en gran medida los desechos radiactivos que se almacenan cerca de las plantas de energía. 

Estas baterías de diamante se consideran no contaminantes. En cambio, una batería de un móvil actualmente podría contaminar 600.000 litros de agua.

Por otro lado, las baterías de diamante tendrán una duración mucho más larga que las habituales. Hoy en día, una batería de coche dura unos 8 años si se desgasta y recarga de forma diaria, en cambio, estas nuevas baterías durarán 28.000 años.

La batería es totalmente segura para los humanos ya que el diamante radiactivo está envuelto en múltiples revestimientos de diamantes sintéticos de alta duración, según asegura la empresa fabricante. 

Una tecnología con muchas posibilidades
La primera industria en la que se espera aplicar esta tecnología es la aeroespacial, pero también se busca ponerla en práctica en la industria automotriz, electrónica de consumo o tecnología médica.

Estas baterías podrían alimentar dispositivos complejos como ciertos tipos de naves espaciales, por ejemplo, satélites. No obstante, también podrían dar energía a objetos cotidianos como móviles o coches eléctricos.

No será hasta 2023 cuando veamos el producto finalizado y podamos comprobar si es cierto lo que promete."
7/11/2020,Lifestyle,288,35,26,33,382,La crisis medioambiental se hace notar en el World Press Photo,"La edición 2020 del World Press Photo llegó a Barcelona.

Se trata del más prestigioso concurso anual de fotografía de prensa. Allí se exponen las fotografías ganadoras del concurso de fotoperiodismo y fotografía documental más importante del mundo. En cada edición, el concurso premia a las imágenes más destacadas del año anterior.

La exposición puede visitarse desde el 13 de noviembre hasta el 20 de diciembre en el Centro de Cultura Contemporánea de Barcelona (CCCB). Lo novedoso de este año es que se ofrece una visita guiada virtual online en la plataforma Filmin y está disponible de forma gratuita para todos sus abonados.

Durante más de tres semanas, 17 profesionales del sector analizaron con paciencia un total de 73.996 fotografías tomadas por 4282 fotógrafos de 125 países de todo el mundo, para elegir las 157 imágenes de las ocho categorías distintas, entre las que encontramos medioambiente y naturaleza.

Este concurso existe desde 1955. Sus objetivos son acercar el periodismo visual al público global, mostrar los acontecimientos más importantes del año por medio del lente de fotoperiodistas de diversos lugares del mundo, estimular la reflexión, fomentar la libertad de prensa y de expresión y el derecho a la información, dando a conocer los hechos de manera veraz y sin filtros mediáticos. También, brinda la oportunidad de mostrar historias que no han sido difundidas por los medios de comunicación. La exposición viaja por todo el mundo, sin censura alguna.

La crisis climática en imágenes
Una cuestión fundamental que se destaca este año en el concurso es la crisis climática y medioambiental. En esta edición muchos fotógrafos documentan los efectos de este problema que nos toca de cerca.

Por causa del fuego o del agua en 2019 murieron miles de personas y millones de animales y muchos hogares fueron completamente destruidos. El calentamiento global provoca sequías y eleva las temperaturas, seca los bosques y facilita los incendios, como los producidos en Australia, que podemos ver a través de la fotografía de Matthew Abbot. También se hacen presentes las catástrofes naturales como la imagen del huracán de Bahamas, tomada por el fotógrafo español Ramón Espinosa. En esta arista, nos impacta también una imagen del permafrost de Katie Orlinsky. Se trata de la desaparición del suelo congelado que cubre enormes superficies del hemisferio norte; esto produce que se pudran los vegetales que ha contenido durante siglos, liberando gases que empeoran el efecto invernadero y quienes viven en la zona ven hundirse sus casas y complicarse su modo de subsistencia.


La amenaza de los gases de carbono.
Katie Orlinsky para National Geographic.
(3º Premio Medioambiente, Historias)
Otro aspecto de la crisis medioambiental es cómo desaparecen las fronteras medioambientales entre el ser humano y la fauna salvaje, de forma que nuestra relación con animales exóticos es cada vez más estrecha y provoca nuevos problemas. En este aspecto, encontramos fotografías de cazadores furtivos, traficantes y vendedores de fauna exótica. También, entre las imágenes nominadas, encontramos animales en peligro de extinción como los orangutanes. La tala indiscriminada de árboles ha reducido las junglas donde viven y se ven obligados a convivir con los seres humanos en una relación, a menudo, conflictiva. En otra fotografía, de Alain Schroeder, vemos a un grupo de personas de una entidad protectora animales rescatando orangutanes heridos para luego devolverlos a su hábitat natural. Asimismo, podemos observar algunas fotografías de tigres en cautiverio ya que en la actualidad viven más tigres en cautividad que en su hábitat natural.

Es importante destacar la gran cantidad de fotografías seleccionadas que se relacionan con la crisis climática, lo que demuestra la importancia del periodismo visual cuando se trata de mostrar las historias que le importan al común de la gente. Todas estas imágenes buscan llamar nuestra atención, no dejarnos indiferentes, hacernos pensar, reflexionar. Luego de recorrer la muestra reflexionemos sobre la forma en que interactuamos con la naturaleza y tomemos consciencia de las consecuencias que trae la pérdida de biodiversidad en el planeta."
23/10/2020,Lifestyle,121,62,3,12,198,La economía del renting,"Actualmente vivimos en unos tiempos donde la incertidumbre acapara gran parte de
la vida de los ciudadanos de todo el mundo. Con ello, las empresas, ya buscan
alternativas para sostener el sistema de consumo.

La actual tendencia en la que está inmersa la economía, es lo que se conoce como:
economía circular. Una manera de invertir más sostenible. Este tipo de inversión,
es conocida por generar beneficios en muchas personas a la vez.

Muchos gigantes del comercio electrónico y del interiorismo ya están empezando
a aplicar esta nueva forma de invertir a sus políticas de empresa. Esto los acerca
hacia un nuevo perfil de cliente: el cliente sostenible. Este ya no está tan
preocupado por la estética del producto, sino por el uso.

Uno de los mayores beneficios que conlleva aplicar la economía circular a diferentes
sectores del mercado, es la reducción de la huella medioambiental. Estas nuevas
formas de inversión, promueven el cuidado del medioambiente y un descenso de
producción en grandes fábricas.

El sector textil deja alrededor de un 20% de consecuencias negativas en la atmósfera. Es por ello que, los clientes, cada vez más conscientes de esto, buscan una moda más sostenible. Así nacen los Rentings de ropa.
Estos negocios se dedican al alquiler de prendas que por alguna razón ya no tienen
uso. De esta manera, se minimizan los efectos negativos que las cadenas de
producción dejan en el medioambiente y la compra compulsiva de estos productos.

‘’Se estima que sólo un 30% de la ropa que se compra acaba
teniendo un buen uso’’.
‘’Ecoadicta’’, ‘’¿Me lo prestas?’’, ‘’Pantala’’y ‘’SFKF Circular’ son empresas que
ya destacan en el comercio del alquiler de prendas. Todas ellas, tienen un fin
medioambiental en sus ideales de empresa. Pero no sólo existen los alquileres de
prendas. El sector joyero, también se está sumando a esta tendencia sostenible.

Sin duda, una de las empresas españolas que más crece en este ámbito es
PISLOW. Esta empresa de fashion renting está creada por dos españolas. Una
buena combinación de técnicas digitales y marketing, han hecho que esta empresa,
se haya posicionado como la favorita en el comercio de la moda sostenible."
13/01/2020,Lifestyle,12521,4019,3,9,16552,La fórmula de la juventud sí que existe,"Se trata del Resveratrol, la “fórmula milenaria” de la juventud que contienen las uvas, arándanos, frambuesas, moras y otros frutos rojos en menor proporción. Si ya se encuentran haciendo la deducción lógica, sí, también el vino. 


El Resveratrol es un tipo de fenol natural que contienen las plantas para defenderse de los ataques externos que pueda sufrir. Malas condiciones climáticas para su crecimiento, distintas enfermedades o situaciones de estrés. De la misma forma que la planta crea este mecanismo de defensa, al consumirla, accedemos a los mismos beneficios. 

“Debido a su carácter antioxidante se le atribuyen efectos protectores a nivel cardiovascular ayudando a la reducción en la absorción de colesterol y la agregación plaquetaria. Además desarrolla acciones antiinflamatorias y anticancerígenas”, asegura Cinthia Kwaterka, licenciada en Nutrición de la Clínica y Maternidad Suizo Argentina para Perfil.com. Se conoce al Resveratrol como la “fórmula de la juventud” debido a su gran poder para bloquear los efectos del envejecimiento. 

Este “superalimento” se encuentra de manera natural en mayor cantidad en el vino tinto que en cualquier otro. Lo cierto es que para poder consumir alrededor de 250 miligramos por día, que es la cuota sugerida por los especialistas, con una o dos copas de vino no es suficiente. Entonces, la recomendación es “beber solamente por placer ya aporta cierto grado de la sustancia al cuerpo. Si además se complementa esto con la ingesta de arándanos y uvas se estará aportando una cantidad sustancial” según declaran para Perfil.com. Además, si estas frutas son de origen orgánico o «real» sumarán respecto a su calidad."
29/07/2021,Lifestyle,356,158,61,12,587,La tendencia digital de apilar piedras resulta peligroso para el medio ambiente,"Con la llegada del verano, crece la incidencia de una peligrosa tendencia que está destruyendo el medio ambiente e inunda las redes sociales: apilar piedras. Y aunque en algunas culturas esto puede tener una connotación espiritual, la realidad es que para el medio ambiente, puede acabar con la biodiversidad de algunas zonas naturales protegidas. 

“Hace siete u ocho años hemos visto los primeros montículos, y ahora es una explosión’’- Según informa Jaume Adrover, portavoz de la organización ecologista de Mallorca Terraferida en declaraciones al Diario La Vanguardia.

Baleares y Canarias son las más afectadas por esta nueva tendencia digital. En algunos casos, llegando a parajes protegidos como es el caso del Parque Natural del Teide en Tenerife o el Parque Nacional de Sa Dragonera en Mallorca. Pero esta moda de apilar piedras se extiende rápidamente por todo el territorio.

Una moda con efectos colaterales 
El apilamiento de piedras supone para el medio ambiente la pérdida de ecosistemas y especies, ya que de éstas tienen una función de reguladoras de humedad. Haciendo crecer plantas entre ellas y de las cuales, posteriormente, se alimentan especies. Además, actúan como microclimas para algunos ecosistemas. En lugares como Madeira (Portugal), empiezan a desaparecer las primeras especies endémicas como: la lagartija “Teira dugesii’’ por este hecho. Y flora, como la variante de musgo “Riccia Atlantica’’. 

Desde el Consejo Superior de Investigaciones (CSIC), se pide tomar medidas que no contribuyan a avivar esta nueva moda digital. El Gobierno Balear en conjunto con la Sociedad Española de Ornitología- donde la situación es ya muy preocupante-, se están estudiando planes de actuación para reducir la presión humana en determinados puntos de la isla.  En lugares como Menorca, ya existen señales que prohíben apilar piedras en zonas de costa. Y Ayuntamientos como el de Camariñas, en Galicia, han impuesto multas de hasta 6.000€ para aquellos que modifiquen el patrimonio natural del lugar. 

Otro peligro digital es hacia las estrellas de mar
Sin duda, las redes sociales, son la nueva amenaza para el medio ambiente. Pero la actividad humana no solo deja daños a nivel costero. Sino que, el deseo por conseguir una fotografía y un puñado de «likes», deja también daños, en valiosos ecosistemas marinos. Una de las especies más amenazadas por este mismo hecho son: las estrellas de mar. 

Esta especie que habita en océanos de todo el mundo y a profundidades de casi 6.000 metros, es una de las especies marinas más fotografiadas por los humanos. Sacarlas del mar supone para ellas la muerte por intoxicación. Además, investigadores marinos, advierten que, la invasión humana en zonas próximas a sus hábitats, aumenta el riesgo de muerte por estrés de las estrellas marinas. 

Expertos de la Universidad Estatal de Oregón, alertan de la importancia de no modificar los ecosistemas y sus hábitats. Ya que esto supondría graves daños medioambientales y perjudiciales para la actividad natural del planeta."
26/05/2021,Lifestyle,939,167,55,6,1167,La UE aprueba el gusano de harina como alimento,"El pasado 3 de Mayo la Unión Europea aprobó la propuesta de comercializar el primer insecto apto para la alimentación. Se trata del gusano de harina. Este insecto procede de las larvas del escarabajo “Tenebrio Molitor” y en pocos meses podrá comercializarse en la Unión Europea como alimento.

Esta medida tomada por la Comisión Europea forma parte del ‘Pacto Verde’, una estrategia europea que identifica a los insectos como un alimento rico en propiedades para el ser humano. Lo que se busca es fomentar la alimentación sostenible.

Los beneficios de consumir gusano de harina son tanto para las personas, como para el medioambiente.
La cría de estos insectos, aportará grandes beneficios medioambientales. En primer lugar, porque el gusano de harina se alimenta de residuos biológicos. Además, minimizará el impacto de los residuos en la tierra. Estas especies son resistentes a las sequías y no dependen directamente de la actividad de la tierra. Esto significa que la escasez de un recurso no evitaría su producción. Lo contrario pasa con el ganado tradicional, que depende constantemente de recursos externos para su producción.

El gusano de harina se podría consumir como snack o como preparado para harinas de repostería o pastas. También como saborizante o suplemento deportivo. 
La Autoridad Europea de Seguridad Alimentaria, avala que tienen un gran aporte proteico y fibra y contienen micronutrientes como hierro, cobre y cinc, y un alto contenido en ácidos grasos, equivalentes a los del pescado.

Solo el 10% de las personas dicen estar dispuestas a reemplazar a la carne por insectos para alimentarse.
En Europa la venta de insectos tiene un nicho de mercado casi inexistente. Y en España, hay un vacío legal. Aún no hay fecha estimada para la venta del gusano de harina.

Los gusanos como superalimento serían la clave para acabar con algunos problemas que atraviesa el mundo debido a la producción excesiva de alimentos de proteína animal, según informa la BBC.

En el mundo se consumen alrededor de 1.900 especies, entre ellas: escarabajos, orugas o avispas. En muchos lugares de Asia o África algunas especies están consideradas como manjares de lujo. La oruga de la mariposa emperador o los huevos de hormiga tejedora, son algunas de ellas. 

Los habitantes de los diferentes países de la Unión Europea no ven con buenos ojos la introducción de insectos en su alimentación. En países como: Tailandia, China o México, esta práctica, gira entorno a la cultura del país."
6/02/2020,Lifestyle,253,82,3,88,426,La verdad de la milanesa (de soja),"¿Cuánto sabemos de los aditivos y sustancias que se le incorporan a este alimento? Probablemente por el ritmo de vida acelerado que llevamos quienes vivimos en la ciudad, consumimos alimentos que están -según creemos- más al alcance de la mano que otros; este es el caso de los congelados. La milanesa de soja se ha vuelto la estrella, pero vamos a derribar el mito de sus beneficios: se trata del alimento más procesado en la industria.

¿Y esto qué significa? Según Martín Piña y Sebastian Oddone, autores de “Mitos y verdades de los alimentos” hay tres tipos de mecanismos para industrializar un alimento.

Químico

Hace referencia al grado de ingredientes y aditivos añadidos. Más específicamente, conservantes, antioxidantes, espesantes y más. Estos, no poseen valor nutritivo. Son añadidos simplemente para modificar sus propiedades según lo que requiera ese producto en particular, por ejemplo, que dure más.

Físico

Éste es el mas común. Todo alimento sometido a un procesamiento químico también es sometido a un procesamiento físico. Los ejemplos más comunes son la congelación, cocción, esterilización o pasteurización. Su objetivo es que este permanezca inocuo por un tiempo.

Biológico

En este tipo de procesamiento el producto sufre cambios generados por agentes biológicos. Generalmente al yogurt y a los quesos que llevan microorganismos se les realizan fermentaciones. También están los modificados genéticamente como la soja el maíz y sus derivados.

¿A qué tipos de procesos se somete a la milanesa de soja? ¡A los tres!

Biólogicamente porque se utiliza soja transgénica entre sus componentes. Químicamente se le incorporan aditivos, y físicamente porque se la somete a congelación.

Entonces, ¿La milanesa de soja es mala? En sí, no es un producto que nos pueda hacer daño de manera directa o a corto plazo, de hecho, la soja natural es buena ya que nos  aporta bastante cantidad de proteína. Pero lo cierto es que la soja utilizada para la milanesa es un alimento altamente procesado y se utiliza glifosato para su cultivo. A esta soja modificada genéticamente se le añaden herbicidas para que crezca fuerte y masivamente. El glifosato incorporado por la planta también lo incorporamos nosotros y es considerado cancerígeno.

Consumir soja de origen natural y no procesado. Éste es el mejor consejo."
5/12/2019,Lifestyle,70,39,0,0,109,Los mejores safaris ecofriendly,"Amantes de los animales: aquí tenemos los dos safaris que todo ecolover debe tener en su bucket list.

Sin lugar a duda los safaris son viajes que jamás se olvidan. La adrenalina de embarcarse en esta aventura y avistar animales es una experiencia única.
¿Los mejores 2?

Masai Mara
Se encuentra en Kenia y es el más elegido. Si esta es tu primera experiencia de safari, este paisaje te dejará sin aliento. Sus llanuras, colinas y árboles solitarios en medio, llenan la mente de calma. ¡El amanecer es vista obligada!

Se trata de una de las reservas salvajes más grandes de África, una reserva natural que en realidad es una extensión del Serengueti. Esta línea de fallas de 5.600 kilómetros de largo se extiende desde el Mar Rojo hasta Mozambique.

¿Necesitas más motivos para visitarlo?

Encontrarás a los “cinco grandes”, leones, leopardos, elefantes, búfalos y rinocerontes negros. Es que más del 40% de las especies de mamíferas africanas pueden encontrarse allí. También más de 300 especies de aves.

¿Cuándo ir? Entre julio y octubre, para no perderte la migración de ñus, los reyes del Masai Mara.
¿Cuántos días destinarle? Entre tres y cuatro. 


Photo by Ron Dauphin
Okavango – Moremi game reserve
Un paisaje único, dado por un río que no muere en el mar, si no en el desierto. De eso se trata esta reserva ubicada en Botswana.
El oasis más grande de África es el hogar de las especies en mayor peligro de extinción: leopardos, rinocerontes blancos y negros, leones y perros salvajes africanos. También, podrás observar algunas de las 500 especies de aves, algunas de ellas, acuáticas. 
Este es, uno de los ecosistemas más asombrosos del planeta.

¿Cuándo ir? Todo depende de qué esperemos ver. En invierno en los meses de junio y julio, los animales se concentran alrededor de las lagunas y la vegetación está en su verde máximo. Llegando a Agosto, algunas zonas se inundan y sube el delta, momento en que se crea una maravilla natural. Septiembre y octubre se caracterizan por ser meses de mucho calor, en los que los animales se mueven en busca de agua y se los puede ver agrupados en los canales. 
¿Cuántos días destinarle? Entre dos y tres.
"
2/06/2020,Lifestyle,227,79,9,27,342,"Más ganado, mayor deforestación","Casi tres cuartos de la tierra agrícola en el mundo se utiliza para la producción de ganado e implica un costo muy grande para la biodiversidad. Para producir carne es necesario deforestar.

La ganadería industrial representa un 70 % de la deforestación en el planeta y repercute directamente en la salud terrestre, generando menos cantidad de oxígeno disponible, desplazando a animales de sus hábitats naturales y emitiendo gases de efecto invernadero.
El sector ganadero contribuye significativamente a una parte importante de emisiones humanas de gases de efecto invernadero (GEI), según la Organización de las Naciones Unidas para la Alimentación y la Agricultura (FAO). Las emisiones del sector a nivel global representan ya el 14,5%.

Otro problema que se presenta en la actividad es el uso del agua. Para producir 1 kg de carne se utilizan 15000 litros de agua.  El 41% de las masas de agua subterránea están contaminadas por los purines (residuos fecales) procedentes de las granjas de cerdos. En este caso, la contaminación consiste en un aumento de la concentración de nitratos en el agua superficial y subterránea, que puede provocar problemas de salud en las personas.

La ganadería es dañina para el medio ambiente, y la cuestión no reside en dejar de consumir carne por completo si uno no lo desea, pero sí en reducir su consumo. La agricultura y la producción agrícola también afectan al medioambiente y erocionan continuamente la tierra. El uso de pesticidas y herbicidas generan un potencial daño en el medio ambiente ya que se utilizan enormes cantidades de agua para la producción. Pero, en comparación, la producción ganadera es más contaminante que la agrícola.

La industrialización de alimentos y la producción para consumo masivo generan muchos desechos e impacto ambiental. Resulta, en este punto, sumamente necesario tomar medidas para apaciguar estos efectos. Ésta es una de las causas del movimiento Real food, que busca además cambiar nuestra alimentación en favor del medio ambiente."
19/12/2019,Lifestyle,188,61,0,30,279,Mascarillas faciales naturales in house ,"La piel de nuestro rostro es la más sensible.
¿Has pensado alguna vez en el origen y la bondad de los productos que le aplicas a diario?

Francisca González, cosmetóloga naturista, nos devela cuatro recetas de mascarillas que podemos hacer en casa con componentes naturales, ¿Y por qué no? Si así lo quisiéramos orgánicos o bio.

Máscara aclarante para pieles con manchas 

Ingredientes
1 cucharada de yogurt natural 
10 gotas de limón 
½ cucharada de miel

Procedimiento
Mezcla los ingredientes, pincela el rostro y deja actuar 20 minutos. Para ver resultados, debes aplicar esta mascarilla dos veces por semana. 
Recuerda descartar la preparación luego de cada uso. 

Máscara hidratante

Ingredientes
Agua hervida
1 cucharada de aceite de oliva
1 saquito de té de tilo
1 saquito de té de manzanilla

Procedimiento
Mezcla los ingredientes y aplica con una toalla.

Máscara antiage

Ingredientes 
1 cucharada de cacao puro
1 cucharada de aceite de oliva
1 cucharada de azúcar mascabado

Procedimiento
Mezcla los ingredientes y aplica con tus manos. 

Máscara detox

1 trozo de pepino
120 cc de leche 

Procedimiento 
Mezcla los ingredientes, déjalos reposar en la heladera durante 3 horas, pincela y remueve con una gasa. Para ver resultados, debes aplicar esta mascarilla cuatro veces por semana."
13/02/2020,Lifestyle,79,58,0,3,140,"Mejores diamantes, en todos los sentidos","Mimoke es alta joyería ética. Con foco en la innovación tecnológica, crean diamantes de laboratorio que cuidan a la tierra y a las personas. Son mejores diamantes en todos los sentidos. Sergio Murcia, CEO y fundador, nos cuenta sobre este emprendimiento que toma cada vez más fuerza. 

¿Qué significa la joyería «ética»?

Es joyería que se produce a partir de tomar diferentes decisiones sobre todo a nivel de operaciones, para hacerle el mínimo daño al planeta y cuidar a la gente. La ética parte de revisar todos los procesos ya estandarizados y darles una vuelta sostenible. En la joyería tradicional se transporta mercancía de punta a punta del planeta sin tener en consideración el daño medioambiental. Desde Mimoke apostamos a crear las mismas piezas, pero en el laboratorio. Nos dedicamos exclusivamente al mercado en el que trabajamos y creamos puestos de trabajos cualificados y bien retribuidos.

¿En qué consta el proceso del diamante de laboratorio? 

Lo que hacemos es replicar las mismas condiciones de la naturaleza (carbono, agua, temperatura y tiempo), pero en un medio controlado. Para extraerlo de la mina hacen falta mover millones de toneladas de tierra, gastar millones de litros de agua y energía. El diamante de laboratorio también requiere de recursos, ¿Consume energía? Sí, pero no deja de ser la mitad de lo que se gasta en producir uno natural. 

¿Por qué elegir joyas éticas? 

Porque al final se está optando por un producto que no daña a la naturaleza, que cuida a las personas y se comercializa a un precio que consideramos más justo. Es posible acceder a joyas realmente dignas a partir de 500 euros. Los diamantes naturales y de laboratorio son exactamente iguales. Su diferencia se encuentra a nivel molecular, pero ópticamente no existe ninguna diferencia. "
17/12/2019,Lifestyle,99,53,0,3,155,NO al desperdicio de comida,"Solo en España 7,7 millones de toneladas de alimentos anuales acaban en la basura. Se trata del séptimo país de la Unión Europea que más despilfarra, según la FAO. En América Latina, se desperdiciaban más de 127 millones de toneladas según el informe de 2017 de este mismo organismo.

¿Cómo evitar el desperdicio de comida? Diferentes organizaciones y aplicaciones combaten a diario esta problemática que afecta al mundo.


Olio
Con esta app, disponible en 32 países, puedes subir una foto del alimento que no deseas comer y la primera persona que lo solicite, podrá retirarlo. Este intercambio es gratuito, al igual que la aplicación, que ya ha salvado más de 635.000 de alimentos.
“Nuestro gran rival es el cubo de la basura. Usar Olio tiene que ser igual de fácil, pero significativamente más divertido, y eso lo aporta el contacto humano”, explica la emprendedora Saasha Celestial-One Para El País.

Too Good to go
Se trata de una app que permite a restaurantes, supermercados y otros establecimientos vender la comida que les sobra en el día a precios reducidos.

“Al salvar un pack de comida a través de Too Good To Go estamos ahorrando el mismo CO2 que emitiría un coche tras recorrer 7,9 kilómetros o el que produciríamos si dejáramos la luz de casa encendida toda una semana” cuenta Carlos García, representante de la compañía. Añade con orgullo que “Actualmente, hemos conseguido un hito y es que ya estamos salvando un pack cada segundo en Europa, esto quiere decir que cada día estamos salvando como mínimo 86.400 packs”."
6/06/2021,Lifestyle,319,97,43,15,474,Obsolescencia programada: qué es y por qué erradicarla,"¿Has notado que los aparatos eléctricos cada vez duran menos? Esto se debe a la obsolescencia programada. Es decir, los fabricantes deliberadamente los diseñan y programan para que fallen o se vuelvan obsoletos después de un período corto de tiempo. La finalidad es aumentar la tasa de reemplazo y, en consecuencia, incrementar las ventas. 

La obsolescencia programada genera una sobreexplotación de los recursos naturales necesarios para los productos, cuya producción emite Gases de Efecto Invernadero. Una vez que los productos son desechados, sus materiales tóxicos son liberados al ambiente. En 2019, sólo el 20% de los más de 50 millones de toneladas de desechos electrónicos fueron reciclados. Para hacernos una idea, 50 millones de toneladas equivaldrían al peso de 6 millones de elefantes. 

La excusa es que este tipo de producción impulsa el crecimiento de las empresas, crea gran cantidad de puestos de trabajo, promueve la innovación y la mejora de la calidad de los productos. Como resultado, se logra que los productos sean cada vez más baratos y que estén disponibles a más cantidad de personas.

Francia ya cuenta con una ley para sancionar la obsolescencia programada
La “ley Hamon” de 2014 es la primera ley del mundo en sancionar esta práctica, exigiendo a las empresas que sean transparentes al comunicar la vida útil de sus productos. Gracias a esta ley, se ha abierto una causa criminal en contra de Epson, convirtiéndose en el primer caso del mundo de obsolescencia programada. Otros muchos países están comenzando a tomar medidas legislativas para ponerle freno.

Beneficios que traería su eliminación
Si las empresas comenzaran a evitar esta práctica, habría un mayor ahorro energético, reducirían las emisiones de Gases de Efecto Invernadero, el agotamiento de recursos naturales y la basura electrónica. Además, generaría ahorros en los consumidores y se crearían miles de empleos gracias a la promoción de la economía circular.

Por todos estos motivos, resulta fundamental la regulación de esta actividad estableciendo obligaciones a los productores de aumentar la vida útil de sus productos y reducir sus desechos electrónicos. Así, los consumidores conozcan de antemano la vida útil de los productos y sus componentes. De este modo, se podrá generar una conciencia social que exija mayores prácticas sostenibles para asegurar que las generaciones presentes y futuras gocen de un ambiente sano."
10/12/2019,Lifestyle,67,29,0,3,99,Top 5 de destinos acuáticos en europa,"¿En búsqueda de sumergirte en una aventura? 

Seleccionamos los sitios favoritos para hacer snorquel en europa. Sí, de esos en los que el color del agua y las especies marinas hacen ver gris al resto del mundo.

5. Ghar lapsi – Malta-
A tan solo un kilómetro de la famosa gruta azul (Capri), se encuentra esta piscina de agua natural y templada y una playa rocosa que hace el paisaje de afuera del mar tan bello como el de dentro. Los lugareños se pasean y disfrutan de sus aguas, todavía no demasiado inundadas de turismo.

Las cuevas submarinas tienen la profundidad perfecta para que la luz ilumine todo el escenario marítimo. Podrás encontrar peces de todos los colores y además pecios, que ya sirven de hogar a las especies de la región.

4. Islas Medes -España-
El Parque Natural de Montgrí alberga a estas siete islas que son hogar de la fauna y flora más característica del mediterráneo.

Corales, algas, peces en abundancia y de diferentes tamaños: todo esto vas a encontrar si te sumerges en sus aguas. En especial, debes estar atento a los meros, el mayor atractivo de este archipiélago.

Dos sitios imperdibles: Pedra de Deu, repleto de meros y langostas y Dofí Sud,  que se caracteriza por contar con una gran variedad de especies.

3. El Hierro -Islas Canarias-
La reserva marina de La Restinga fue declarada por la Unesco como Reserva de la biosfera y en la actualidad planea convertirse en la primera isla del mundo en contar únicamente con energías renovables.

Por fuera del agua verás paisajes volcánicos impresionantes; pero no lo dudes: dale una oportunidad al paisaje submarino. Peces, mantarrayas, tortugas, delfines y hasta tiburones ballena.

2. Arrecife Koundouros -Grecia-
Uno de los arrecifes de corales favoritos para hacer inmersiones. En Koundouros, ubicado en la isla de Kea y en todo Grecia el fondo marino es considerado como uno de los más importantes en cuanto a biodiversidad. Este brinda un gran pantallazo de todas las especies del mediterráneo. ¿A qué debes estar atento? Los más afortunados pueden avistar tiburones pequeños, focas y tortugas.

1. Islas Kvarner – Croacia-
La costa croata es un destino muy popular para los buceadores por su numerosa cantidad de islas. Entonces, si decides ir, hacer un tour por las distintas islas al estilo hop on hop off es una buena opción. 

Kvarner tiene aguas cálidas y poco profundas, de aproximadamente 40 metros y arrecifes rocosos. Al igual que en la costa amalfitana, se puede encontrar en Bisevo la cueva azul. La diferencia es que en esta cueva sí se puede bucear, lo que la convierte en una experiencia única."
8/09/2021,Lifestyle,667,76,24,2,769,Tripulación aérea y de ferrocarriles utilizarán uniformes sostenibles,"Hace unas semanas, EasyJet anunció que su tripulación comenzará a vestir con uniformes sostenibles. La empresa británica low cost reveló que su tripulación vestirá con uniformes hechos a base de botellas de plástico recicladas. Ferrocarrils de la Generalitat de Catalunya (FGC), también implementó un sistema de reutilización y reciclaje de antiguos uniformes. 

Numerosos informes demuestran el daño que está dejando la industria de la moda en nuestro planeta. Tan solo la producción de ropa representa el 10% de las emisiones de CO2 a nivel global, según Greenpeace, lo cual equivale a lo que libera la Unión Europea por sí sola. 

Es curioso que las empresas de transporte, siendo una de las industrias más emisoras de CO2, sean las que quieran dar una imagen de sostenibilidad. La aviación contribuye con alrededor del 2% de las emisiones mundiales de carbono del mundo, según la BBC.  

Cada uniforme de Easyjet se fabrica con alrededor de 45 botellas de plástico recicladas
La empresa Tailored Image es la encargada de crear esta vestimenta sostenible para la que utilizaron material de alta tecnología. En comparación con el uniforme no reciclado, el nuevo es más resistente al desgaste por la fricción. La tela sostenible es más elástica y da más libertad de movimiento. Además, al ser más duraderos, no habría que producir de forma masiva.

La colaboración será de 5 años y se estima que se evitará que 2.700.000 de botellas de plástico terminen en vertederos o en los océanos.
FGC también cambió los uniformes de sus empleados por uniformes sostenibles
Según explicaron, »buscan fomentar la participación, la implicación y la suma de talento de todas las personas que forman parte de la compañía». 

Estos uniformes fueron fabricados por proveedores y talleres de proximidad para impulsar la economía local y también para evitar emisiones de carbono en su transporte. FGC ha puesto además en marcha un sistema de reutilización y reciclaje de la ropa sustituida. La compañía ha firmado un convenio con la Fundación Formació i Treball para hacer posible que a partir de un modelo de economía circular se pueda dar un nuevo uso a los antiguos uniformes.

En un mundo donde la imagen y el marketing “lo son todo”, era de esperarse que las empresas quieran mostrarse “más verdes”. La realidad es que, aunque sea por una cuestión de moda y porque es lo que vende actualmente, nuestro planeta lo agradece."
16/10/2020,Lifestyle,222,73,12,12,319,"Turismo covid free, sobre ruedas","La pandemia del coronavirus está dejando consecuencias devastadoras a nivel económico, social, y por supuesto, sanitarias. Con ello, algunos sectores se han visto fuertemente golpeados por estos efectos. Entre ellos, el sector turístico.

Este sector ha tenido que modificar sus medidas y acondicionar nuevos protocolos de seguridad. Pero además de enfrentar una fuerte caída en las ventas, una nueva tendencia llegó pisando fuerte. El turismo rural se desmarca en gran medida, frente al turismo de costa. El turista ya no busca sol y playa. Sino que busca espacios donde poder conectar con el medio ambiente y huir de las aglomeraciones.

Según el portal escaladarural.com, la semana del 29 de Abril al 5 de Mayo, se registró un fuerte aumento de reservas en sus espacios.

En menos de una semana, las reservas de servicios relacionados al turismo rural creció un 122%
Otro negocio en alza, y que el coronavirus ha precipitado, ha sido la venta o alquiler de autocaravanas, vehículos acondicionados para poder hacer vida dentro de ellos. Estos vehículos ya desbancan a los hoteles como lugares para alojarse durante un viaje.

Las autocaravanas permiten dormir en espacios abiertos, facilitan al usuario poder organizar la ruta a su gusto, y por supuesto, explorar espacios donde otros transportes, como avión o trenes, no acceden.

Bien es cierto que, durante estos últimos años las matriculaciones de autocaravanas se han cuadriplicado. Según datos de la Asociación de la Industria y el Caravaning, el negocio de las caravanas ha crecido hasta un 42%, respecto al año anterior. 

A esta nueva manera de viajar, más sostenible y sobre ruedas, se le conoce como VAN LIFE. El perfil del viajero es aquel que desea conocer lugares nuevos, poco masificados y en contacto total con la naturaleza, se trata del viajero sostenible.

El 17% de los viajes que se cancelan o no llegan a realizarse en España se atribuyen a motivos relacionados con la sostenibilidad.
España ocupa el cuarto puesto en el podio de países con mayor número de viajeros sostenibles. Los jóvenes españoles se destacan, junto con franceses y alemanes, por ser conscientes de las emisiones que el sector turístico provoca.

En respuesta a esta tendencia, la industria automovilística ya se encuentra trabajando en nuevos modelos, con el foco puesto en el uso de combustibles menos contaminantes."
30/06/2021,Lifestyle,323,82,49,6,460,Turismo sostenible: ideas para disfrutar del verano,"El 72% de las personas apostarían por el Turismo sostenible ya que valoran que sus viajes generen el menor impacto ambiental posible, según el último informe del Observatorio de Ecoturismo en España. La preferencia por disfrutar de un turismo sostenible está en auge. Esta nueva manera de viajar implica visitar espacios naturales respetando la naturaleza y generando el menor impacto medioambiental posible.

En tiempos de Covid, viajar ya es una opción pero siempre siendo cautelosos frente al contagio. Después de un verano tan distinto como lo fue el del 2020, os sugerimos algunas acciones para exprimir este 2021 de manera sostenible. Las claves del turismo sostenible: reducir la contaminación, respetar el entorno y promover la economía local.

Existen alrededor de 50 propuestas de turismo sostenible
Si decides recorrer España o venir de visita, una propuesta interesante es el Catálogo de Escapadas 2021. Este catálogo reúne 53 experiencias en 20 espacios protegidos emblemáticos del país, que se pueden realizar de junio a diciembre.

Si bien muchas veces buscamos disfrutar de un entorno natural, recorrer paisajes y pueblos, hay que tener en cuenta que estos destinos deberían contar al menos con un espacio protegido como un Parque Nacional, Reserva de la Biosfera o Geoparque, entre otros. 

Por otro lado, el voluntariado ecológico ofrece programas de voluntariado ambiental en todo el mundo. Se ha desarrollado en los últimos años una nueva inclinación a vivir nuevas experiencias, conociendo nuevos paisajes y cuidando al planeta. Los voluntariados más populares son aquellos que contribuyen a la conservación del hábitat de especies amenazadas, la recuperación de zonas devastadas y a ser guía de un espacio natural.

Estas son las variables a tener en cuenta al escoger las vacaciones sostenibles
Opta por alojamientos que se comprometan con el medio ambiente, por ejemplo, que usen energías renovables. A día de hoy existen varias certificaciones de turismo sostenible, Biosphere es una de ellas. De esta forma es más fácil asegurarse que el lugar de hospedaje cumple con una serie de requisitos basados en los principios de sostenibilidad.

Utiliza medios de transporte menos contaminantes para llegar al destino. Una opción es el tren, sobre todo si se decide viajar por el país. Este tipo de transporte genera muchas menos emisiones de CO2 que el avión. Por ejemplo, según la BBC, un viaje en tren de Londres a Madrid emitiría 43kg de CO2 por pasajero. En cambio, en avión esta cifra sería de 118kg.

Respeta la fauna y flora autóctona. Ser cauteloso con el entorno, buscar causar el menor impacto posible en la comunidad. 

Es cierto que el precio sigue siendo un factor determinante a la hora de elegir el destino del viaje. Hay personas que van a seguir priorizando gastar lo menos posible, sin tener en cuenta las sugerencias anteriormente mencionadas. Aun así, exponen desde la Asociación de Ecoturismo en España que muchos desean que el viaje ayude a conservar los espacios naturales que se visitan y que contribuya al desarrollo local. "
27/09/2021,Lifestyle,896,233,6,47,1182,Yvon Chouinard: pionero en la moda funcional y sostenible,"La industria de la moda emite por año 1200 millones de toneladas de gases de efecto invernadero y su consumo ha aumentado un 400 % en los últimos 20 años. Implementar una producción ecoeficiente puede reducir la generación de residuos entre un 10 y un 20 %, según la Fundación Ellen MacArthur.

Muchas veces las prendas quedan en desuso porque pasan de moda: la obsolescencia programada es cada vez más corta. Es importante señalar que la sostenibilidad en la moda se relaciona con la cultura y con los hábitos de consumo. Por eso, a la hora de comprar, resulta importante informarnos, mirar las etiquetas e investigar.

En los últimos años nacieron iniciativas como Fashion Revolution, o Make Fashion Circular que en 2017 reunió a líderes y marcas de la industria de la moda con el objetivo de estimular la colaboración para crear una nueva economía textil, alineada con los principios de la economía circular.

Hay modelos a seguir. Están aquellos que impregnan su filosofía de vida en la empresa y a ella se aferran. Stella McCartney, la hija de Paul, es una diseñadora comprometida con el planeta y eso se refleja en el manejo de su compañía. No solo investiga sobre el impacto de los materiales en el medio ambiente y en los animales, sino que también hace hincapié en las condiciones laborales. Pero quien marcó el camino en la década de 1960, sin dudas, fue Yvon Chouinard, fundador de Patagonia. Su protagonismo se debe a que fue uno de los primeros en desafiar la cultura del consumo y logró hacer compatibles los negocios con el medio ambiente y la conservación.

Toda una vida a favor de la naturaleza
Yvon Chouinard tiene 82 años. Es escalador, surfista, pescador, esquiador y amante de los deportes de riesgo, y, es el fundador y propietario de Patagonia, Inc.

Yvon comenzó vendiendo material de escalada a sus amigos; productos innovadores que él mismo adaptaba para que no dañaran el medio ambiente. Además fabricaba instrumentos como pitones, empotradores, mosquetones. Este emprendimiento continuó creciendo y comenzaron a producir ropa de montaña.

El concepto de la marca siempre estuvo claro: prendas funcionales, duraderas y simples, diseños de calidad para condiciones climáticas duras. Su departamento textil investigaba para crear tejidos a base de materiales que ocasionen el mínimo impacto posible, como el cáñamo, el algodón orgánico o el poliéster y el nailon reciclados. Actualmente continúan innovando en tejidos, fibras recicladas, algodón de cultivos orgánicos, etc.

Yvon Chouinard con equipamiento para escalada de roca. Fotografía tomada por Tom Frost.
Yvon Chouinard con equipamiento para escalada de roca. Fotografía tomada por Tom Frost.
Diseño funcional y multifuncional
Un producto diseñado para una actividad puede ser perfectamente adecuado para otro propósito. Para Yvon los mejores productos son multifuncionales, por eso aconseja “fabricar menos estilos y diseñar mejor; comprar menos y mejor”.

Todo lo que fabrican debe estar diseñado para ser reparado fácilmente. Algunas de sus tiendas realizan las reparaciones y enseñan a sus clientes a hacerlo ellos mismos. También cuentan con un sistema de reciclaje de las prendas a cambio de un crédito.

Su cultura empresarial
Al dejar a un costado su vida aventurera y convertirse en un empresario, estableció “directrices” aplicables a cualquier proyecto o actividad. Así es como su trabajo gira en torno a una filosofía; ser fiel a uno mismo. Esto está implícito en Patagonia, la gente no compra lo que haces, sino el porqué lo haces.

Un emprendedor medioambiental
Yvon, en su maravilloso libro de memorias: Que mi gente vaya a hacer surf, dice que de lo que se sienten más orgullosos en Patagonia es de haber donado, desde 1985, setenta y nueve millones de dólares en dinero y material, en su mayor parte a pequeños grupos conservacionistas y activistas. Lo hicieron por medio de lo que llamaron un impuesto para la Tierra, comprometiéndose a dedicar un 1 % de sus ventas a la conservación y restauración del mundo natural. Luego, en 2001, junto con su amigo, el pescador de mosca Criag Mathews, fundó 1 % For The Planet, una alianza de empresas que aportan al menos el 1 por ciento de sus ventas anuales netas a organizaciones ambientalistas.

"
30/08/2021,News,835,214,67,3,1119,El hundimiento del barco X-Pearl causa un desastre ecológico en Sri Lanka,"El buque, que contenía alrededor de 1.500 contenedores con materiales plásticos y sustancias químicas, ha dejado las costas del oeste índico sumergidas en una profunda crisis medioambiental de la que tardará en recuperarse. 

‘‘La tripulación detectó una fuga en un contenedor de ácido nítrico, pero ningún puerto pudo solucionar el problema”.

Según informa el diario La Vanguardia.

El navío con ruta hacia Colombo, registró el 11 de mayo una fuga de este material altamente contaminante, después de partir del puerto de Dubái. Pese a que la tripulación advirtió sobre la fuga, los puertos de Qatar y Surat, se negaron a brindar asistencia por las consecuencias que esto pudiera dejar en sus costas.

El buque acabó incendiándose a causa de la fuga. Después de dos semanas sin poder controlar el fuego, acabó hundiéndose en la costa de Negombo, al oeste del país. Esto agravó aún más la situación, ya que todas las sustancias que contenía acabaron derramadas en el mar.

Una gran cantidad de materiales contaminantes fueron arrojados al mar en Sri Lanka
Un total de 80 contenedores con materiales contaminantes como plomo, mercurio y sosa cáustica quedaron a la deriva de las costas del océano índico. Los expertos hablaron de una posible ‘‘sopa tóxica’’, debido a la magnitud y peligrosidad de los vertidos que se pudieran producir. 

Aparte de sustancias químicas, también cayeron una veintena de contenedores con plásticos dedicados a embalajes. Las autoridades del país han prohibido las actividades de pesca en zonas próximas a los 80km. Toneladas de bolas de plástico inundan día tras día las costas meses después del hundimiento del navío. 

Toda la flora y fauna han quedado desintegradas por el vertido de los ácidos que transportaba el buque en su interior
Meses después del accidente, el Océano Índico sigue sufriendo las graves consecuencias de los vertidos provenientes del X-press Pearl. Se registran muertes de especies marinas por encima de la media. En los últimos meses, el desastre marino de Sri Lanka deja un balance de 200 tortugas, una veintena de delfines, toneladas de especies pequeñas de peces y cuatro ballenas muertas. 

Expertos en educación medioambiental afirman que un desastre de semejante magnitud dejará el fondo marino dañado durante décadas. El gobierno del país asegura que ya trabaja en diferentes planes de actuación para mitigar los daños a medio y largo plazo."
5/06/2020,News,116,26,6,9,157,¿Por qué hablamos de biodiversidad?,"Hoy 5 de junio se celebra el día internacional del medio ambiente bajo el lema “La hora de la Naturaleza”. El tema protagonista de este año es la biodiversidad. Pero, ¿qué es la biodiversidad exactamente y por qué es tan importante?

El programa para el medio ambiente de la ONU define biodiversidad como “la variedad de seres vivos sobre la Tierra” y “la base que sustenta toda la vida en la tierra y debajo del agua”. 

No resulta exagerado afirmar que no existiríamos sin los servicios que nos brinda la naturaleza. Agua, aire, alimentos, medicamentos y equilibrio climático son, de manera general, algunas de las maravillas que nos ofrece y que constituyen la base de la vida en la tierra.

Según el informe “El estado de los bosques del mundo” de la ONU, la mayoría de la biodiversidad terrestre se encuentra en los bosques de nuestro planeta. 

Sin embargo, ¿en qué estado se encuentra nuestra naturaleza actualmente? Datos de este mismo informe señalan que entre 2015 y 2020, la tasa de deforestación fue de 10 millones de hectáreas al año, cuando en la década de 1990 era de 16 millones. Sin embargo, la expansión de los bosques se dio de forma inversa. Entre 2015 y 2020 fue de 5 millones de hectáreas al año, mientras que en la década de 1990 fue de 8 millones.

A pesar de que la tasa de deforestación entre 2015 y 2020 fue menor en comparación, la expansión de bosques ha sido la más baja desde 1990 y la pérdida de biodiversidad todavía se sigue dando de forma acelerada.
La principal causa de pérdida de bosques y, consecuentemente, de biodiversidad es la expansión agrícola que avanza a ritmos preocupantes. Esto altera gravemente el delicado equilibrio de nuestra naturaleza y trae consecuencias como la situación que estamos viviendo actualmente: la propagación de enfermedades como el COVID-19. 

Este año Colombia es el país anfitrión de este día. Para celebrarlo se organizaran distintas charlas con expertos en temas de biodiversidad de todo el mundo. Haciendo click aquí podrán seguir cada una de estas apariciones a medida que vayan sucediendo. 

“La hora de la naturaleza” como lema refleja la idea fundamental de que las soluciones las encontramos directamente allí, en nuestra naturaleza.

Es posible, y urgente, encontrar soluciones que nos permitan aprovechar la biodiversidad de forma sostenible y qué mejor forma de hacerlo, si no es escuchando y apoyándonos en aquello que nos da la vida cada día. "
18/10/2021,News,122,23,15,6,166,¿Qué trae de nuevo el borrador de Ley de Protección de los animales?,"El pasado 6 de octubre, el Ministerio de Derechos Sociales publicó el borrador del Anteproyecto de Ley de Protección y Derechos de los animales, la cual pretende que se prohíba la venta de mascotas en tiendas y que los perros no puedan estar más de 24 horas solos, entre otras cosas.

Actualmente, el destino de un animal de compañía que es abandonado dependerá de la Comunidad Autónoma en la que viva. Cada una tiene su ley autonómica. En Cataluña se salva, en Andalucía puede ser sacrificado. Este anteproyecto de ley de protección y derechos de los animales planea que haya una misma norma para todo el país.

Para contextualizar, en 1995 se reguló por primera vez el maltrato animal en el código penal. En su última reforma del 2015, se tipificó por primera vez el delito de abandono de un animal. Las leyes autonómicas de protección animal están sujetas al código penal. Es decir, cuando se da un caso de maltrato o abandono, quien tendrá siempre la “última palabra” será el código penal, explican desde el despacho de abogados DeAnimals.

Este anteproyecto de Ley de Protección animal es necesario para que exista un marco común a nivel nacional
El principal objetivo de esta Ley es regular el reconocimiento y la protección de la dignidad de los animales por parte de la sociedad. Es decir, que regula nuestro comportamiento hacia ellos como seres vivos dentro de nuestro entorno de convivencia. En España, en una de cada tres casas, vive un animal de compañía. Según la Red Española de Identificación de Animales de Compañía, más de 13 millones de ellos están registrados e identificados. Aun así, a día de hoy muchos otros no se encuentran bajo el control oficial, lo cual supone un riesgo tanto para la mascota como para la seguridad y salud pública.

Algunas de las nuevas propuestas de los Derechos de los animales
Los perros pastores o de vigilancia de fincas deberán estar supervisados. No se los podrá dejar solos más de 24 horas. Podrá ser presencialmente, con tecnología GPS o con cámaras de videovigilancia. Por su parte, los animales de las ferias de atracciones no podrán quedarse en sótanos, terrazas, etc. sin supervisión 3 días consecutivos. 

La eutanasia se podrá hacer solamente si está justificada. Solo para evitar el sufrimiento del animal. Queda prohibido, ya sea en clínicas veterinarias o centros de protección animal, sacrificarlos por cuestiones económicas o abandono del dueño.

Se creará un registro de personas inhabilitadas para tener animales. En este estarán las personas físicas o jurídicas que estén inhabilitadas para ejercer la profesión así como para la tenencia de animales. Quedarán todos los datos sistematizados. 

No se venderán más animales de compañía en las veterinarias o tiendas de mascotas. Salvo los peces, ni perros, gatos, conejos, etc. 

Adiós al listado de perros peligrosos. Se necesitará que todos los perros, independientemente de su raza, pasen una prueba de validación. Al igual que las personas deberá hacer un curso para tener perros.

La lista de derechos, prohibiciones y obligaciones, continua. De momento este borrador aún puede sufrir cambios. Primero debe pasar por el resto de ministerios, pero la idea de la Dirección de los Animales es que pueda llegar al Consejo de Ministros en noviembre."
20/04/2020,News,64,6,3,9,82,La inacción climática costaría al mundo cientos de billones de dólares hasta 2100,"El secretario general de la ONU lo aclaró en la antesala de la COP25: el planeta se encuentra en un punto sin retorno. Basándose en informes del IPCC, advirtió sobre los esfuerzos insuficientes de los países. A su vez, instó en la necesidad de que el calentamiento global no supere los 1.5 grados con respecto a los niveles preindustriales. 
Reducir el CO2 es el desafío climático, y un estudio reciente confirma su valor monetario. Su ganancia o perdida depende de la acción o inacción.

“El cambio climático puede conducir a una catástrofe global, por lo tanto, si los países no mejoran sus acciones para cumplir los objetivos climáticos, se producirá un daño que causará pérdidas económicas importantes y afectará al futuro desarrollo económico”, declara a SINC Biying Yu, investigador en el Centro de Investigación de Política Energética y Ambiental del Instituto de Tecnología de Beijing, en China.

En un estudio publicado en la revista Nature Communications, el investigador junto a un equipo internacional presentan un análisis sobre las posibles pérdidas económicas producidas por “el daño climático no evitado”. Según el informe, todo el mundo perdería unos beneficios por un valor de entre 149,78 y 791,98 billones de dólares hasta 2100 si los países no pudieran implementar sus Contribuciones Determinadas a Nivel Nacional actuales

Todo el mundo perdería unos beneficios por un valor de entre 149,78 y 791,98 billones de dólares hasta 2100.
“En otras palabras, el fracaso del mundo para cumplir los objetivos climáticos haría que los beneficios se desvanecieran”, declara el autor del informe. En una primera instancia, para alcanzar los objetivos (reducir las temperaturas y emisiones), los países deberán asumir un coste. Pero este podría ser visto como una inversión por los beneficios que se obtendrían a largo plazo si se logran alcanzar los objetivos de 1,5 o 2 ºC.

¿Cuál es la propuesta?
Los expertos proponen una estrategia de autoconservación para 134 países. Esta estrategia se basa en la gestión de los recursos naturales asegurando el máximo de sus beneficios sostenidos para generaciones actuales y futuras. A estos países se les proporcionaría información sobre los beneficios directos que obtendrían o perderían dependiendo de su accionar frente a la emergencia climática.

¿De qué manera deben hacerlo?
Para adoptar esta estrategia y alcanzar los objetivos globales y cumplir con las sus Contribuciones Determinadas a Nivel Nacional, los expertos insisten en que los países deben adoptar por tecnologías bajas en carbono. Además, subrayan que el esfuerzo para reducir las emisiones requiere la cooperación entre todos los países para que los más vulnerables también puedan optar a la estrategia de autoconservación."
24/03/2020,News,55,23,0,0,78,“Los planes de rescate económico de Covid-19 deben ser verdes”,"La relación entre la crisis sanitaria del covid-19 y la crisis climática es directa. Como consecuencia del confinamiento, las reducciones de C02 en todos los países del mundo han sido considerables. Se estima que los beneficios ambientales serán significativos. 

Pero esta crisis trae consigo la extrema necesidad por parte de los gobiernos de tomar medidas económicas que salven la economía respectiva de cada país. 

En el caso de España, previo a la pandemia, las principales organizaciones ecológicas presentaron al Gobierno una serie de propuestas de fiscalidad ecológica, “con el objetivo de orientar el comportamiento de los agentes económicos y contribuir a la protección del medio ambiente y a la mejora de la justicia social” según Greenpeace. 

«Los gobiernos deben invertir enormes cantidades de dinero para tratar de mantener el empleo y los medios de vida», declaró Mary Robinson, ex presidenta irlandesa y alta comisionada de la ONU para los derechos humanos y enviada climática. “Pero deben hacerlo con un énfasis verde muy fuerte. La amenaza del cambio climático es tan real como la amenaza de Covid-19, aunque parece muy lejana”.

Las industrias que se ven mayormente afectadas actualmente son las de aviación, cruceros y hoteleras entre otras. Éstas sean probablemente beneficiarias de los paquetes de rescate económico; pero también son -no casualmente- industrias que impactan negativamente al medio ambiente. La preocupación de los activistas reside en que la toma de medidas urgentes para paliar la crisis económica deje de lado la necesidad de que sean favorables al medio ambiente. 

«El dinero se ha vertido en la industria de los combustibles fósiles desde el acuerdo de París [de 2015]», dijo Mary Robison. «Eso no puede continuar» cita la nota respecto al tema en The Guardian y añade que “ los cambios producidos en las sociedades de todo el mundo al tratar con Covid-19 también demostrarían a las personas que los cambios necesarios para lograr un futuro bajo en carbono fueron mucho menos drásticos y mucho más agradables. En lo que respecta al clima, «no debemos volver a los malos hábitos después», dijo. «Será más fácil persuadir a las personas, ya que hemos tenido que cambiar tan dramáticamente debido a esta amenaza».

El riesgo es muy alto, señalan los expertos. Si las medidas no se diseñan cuidadosamente, las economías continuarán dependiendo de los combustibles fósiles principales responsables de las emisiones de gases de efecto invernadero, que aún continúan siendo el motor que impulsa la economía mundial."
20/04/2020,News,89,40,0,56,185,170 académicos holandeses firman un manifiesto con las 5 políticas clave post Covid-19,"Las aceleradas decisiones políticas y económicas por parte de los estados para hacer frente a la crisis del Covid-19 son la gran preocupación de los ambientalistas. Consideran que en este momento las decisiones deben considerar las consecuencias que tendrán en una crisis ambiental futura. También, que en este momento pueden tomarse decisiones que sean favorables al medio ambiente. «Todo esto requiere una acción drástica e integrada y hace que sea crítico comenzar a planificar un mundo posterior a COVID-19 lo antes posible» declaran científicos ambientales y sociólogos.

170 académicos de ocho universidades holandesas firmaron un manifiesto con una lista de cinco propuestas para un modelo posterior a la crisis: «Planificación para la post-corona: cinco propuestas para elaborar un proyecto radicalmente más sostenible e igualitario mundo».

«El hecho de que COVID-19 ya ha tenido un impacto económico tan importante se debe, entre otros factores, al modelo de desarrollo económico que ha sido dominante a nivel mundial durante los últimos 30 años. Este modelo exige una circulación cada vez mayor de bienes y personas, a pesar de los innumerables problemas ecológicos y crecientes desigualdades que genera» afirman en el manifiesto.

Estas son las 5 propuestas de políticas clave para un modelo de desarrollo psoterior a COVID-19 que, según los expertos «pueden aplicarse de manera inmediata y sostenida después de que esta crisis particular haya disminuido».

Los cinco puntos clave
1) Un alejamiento del desarrollo centrado en el crecimiento del PIB para diferenciar entre sectores que pueden crecer y necesitan inversión (los llamados sectores públicos críticos, y energía limpia, educación, salud y más) y sectores que necesitan un decrecimiento radical debido a su insostenibilidad fundamental o su papel en la conducción del consumo continuo y excesivo (especialmente el sector privado de petróleo, gas, minería, publicidad, etc.).

2) Un marco económico centrado en la redistribución, que establece una base universal de ingresos arraigados en un sistema de política social universal, una fuerte imposición progresiva de los ingresos, ganancias y riqueza, reducción de horas de trabajo y trabajo compartido, y reconoce el trabajo de cuidado y servicios públicos esenciales como salud y educación por su valor intrínseco.

3) Una transformación agrícola hacia una agricultura regenerativa basada en la biodiversidad conservación, producción sostenible y en su mayoría local y vegetariana, así como proteger condiciones de empleo agrícola y salarios.

4) Una reducción del consumo y los viajes, con un cambio drástico de lujo y despilfarro consumo y viajes a consumo y viajes básicos, necesarios, sostenibles y satisfactorios.

5) Una cancelación de deuda, especialmente para trabajadores y propietarios de pequeñas empresas y para países en el sur global (tanto de países más ricos como de instituciones financieras internacionales)."
5/06/2020,News,29,18,9,3,59,"5 de junio, Día mundial del medio ambiente","Cada 5 de Junio se celebra el Día Mundial del Medio Ambiente. La fecha coincide con el inicio de la Conferencia de Estocolmo de 1972 donde precisamente el tema principal fue el Medio Ambiente. Fue en la Asamblea General de la Naciones Unidas de 1972 que se creó esta efeméride.

Cada año, un país se convierte en anfitrión del Día Mundial del Medio Ambiente y se organiza en torno a un tema que sirve para centrar la atención en una cuestión en particular. Se pretende llamar la atención de los medios de comunicación y los Gobiernos para dar a conocer problemas sin resolver que precisan la puesta en marcha de medidas políticas concretas.

Este año, Colombia, con el apoyo de Alemania, es la sede y “Biodiversidad” el tema que la ONU propuso. 

¿Qué es la Biodiversidad?
La Biodiversidad es la variedad de la vida. Incluye varios niveles de la organización biológica. Abarca a la diversidad de especies de plantas, animales, hongos y microorganismos que viven en un espacio determinado. A su vez a su variabilidad genética, a los ecosistemas de los cuales forman parte estas especies y a los paisajes o regiones en donde se ubican los ecosistemas. También incluye los procesos ecológicos y evolutivos que se dan a nivel de genes, especies, ecosistemas y paisajes.

En lo que va del 2020 ya han habido incendios forestales masivos en Brasil, California y Australia, la invasión de langostas en el Cuerno de África y la pandemia de Covid-19. Estos eventos catastróficos recientes demuestran que la naturaleza nos está enviando un claro mensaje. 

Su conexión con el ser humano
La biodiversidad es la base que sustenta toda la vida en la tierra y debajo del agua. Tiene relación con todos los aspectos de la salud humana. Proporciona agua y aire limpios, alimentos nutritivos, conocimiento científico y fuentes de medicamentos, resistencia a enfermedades naturales y mitigación del cambio climático. Cambiar o eliminar un elemento en esta intrincada red afecta todo el sistema de vida y puede producir consecuencias negativas.

Las actividades humanas llevan décadas alterando el planeta, causando una pérdida de biodiversidad sin precedentes. El hielo glaciar se derrite, los arrecifes de coral se han reducido a la mitad y se han perdido grandes extensiones de bosque. 

La deforestación, la invasión de hábitats de vida silvestre, la agricultura intensiva y la aceleración del cambio climático han alterado el delicado equilibrio de la naturaleza. Se necesitarían los recursos de 1,6 planetas Tierra para satisfacer la demanda de los humanos cada año. Si continuamos en este camino, la pérdida de biodiversidad tendrá graves consecuencias para la humanidad, incluido el colapso de los sistemas alimentarios y de salud.

La biodiversidad es la base de toda la vida en la Tierra, y sin ella, la salud humana queda comprometida. Agua limpia, aire puro, alimentos nutritivos, todo ello depende absolutamente de la biodiversidad.

Es por todas estas razones que la Biodiversidad es urgente, es momento que todos nos involucremos en cuidar el planeta, nuestro hogar."
1/09/2020,News,64,26,3,52,145,Adiós a los plásticos de un solo uso,"El plástico de un solo uso debe desaparecer en 2021. El Parlamento Europeo ha decidido que a partir de esa fecha estará prohibida la venta de productos como sorbetes, bolsas o cubiertos de plástico.

En 2015, la producción de plástico alcanzó las 380 millones de toneladas, según Greenpeace. Además, cada año se producen 500 mil millones de botellas de plástico, un producto claramente sustituible. Según la Comisión Europea, el 85% de la basura encontrada en el mar es plástico, generalmente de un solo uso. Entre ellos, cigarrillos, tazas de un solo uso, botellas de plástico o pañales. Residuos que, asimismo, no deberían ser tirados al mar.

Para poder fin a los plásticos es esencial dejar de utilizar todos aquellos productos que ya forman parte de nuestro día a día, pero que, aunque no lo creamos, tienen una alternativa. Existen otros productos de un solo uso que se han comercializado de manera habitual sin pararnos a mirar sus contra indicaciones y el daño que suponen para el medio ambiente como es el caso de las toallitas húmedas o las compresas higiénicas. Su mal uso está perjudicando a gran parte de nuestros recursos.

Aún así, la mayor parte de los plásticos se encuentran en los envases. Los más habituales son los envases de frutas y verduras. Estos envases, totalmente innecesarios, suponen el 40% de la producción según Greenpeace. ¿Cómo dar el paso? ¿Cómo cambiar la forma de consumo para poner fin al plástico de un solo uso? Te lo contamos:

Reemplazar el papel film
Las alternativas pueden ser diferentes. La tela encerada, papeles de diferentes tamaños encerados con cera de abeja que ayudan a mantener los alimentos sin necesidad de taparlos con plástico. Otra solución son las tapas de silicona, útiles para tapar diferentes boles o platos, e incluso sirven con líquidos.

Evitar el plástico para envolver el almuerzo
Las bolsas reutilizables son una buena solución para envolver bocadillos o llevar fruta en su versión bolsa. También puede ser útil la tela encerada.

Olvidarse del plástico para la compra
Las bolsas de malla reutilizables. Con ellas puedes coger los alimentos a granel y pesarlos sin necesidad de recurrir a las bolsas de plástico o a los envases.

Apostar por nuevas alternativas
Al fin y al cabo se trata de un proceso, por eso, debemos ir comprando productos que nos alejen del plástico. Algunos de ellos son los sorbetes de metal o silicona, los cubiertos de bambú, los tuppers de bambú y, una de las más importantes, las botellas de agua de vidrio o metal.

Es posible encontrar el equilibrio, puesto que evitar por completo el uso de estos plásticos de un solo uso es realmente complicado. Al fin y al cabo, el equilibrio se encuentra entre el uso mínimo de plásticos combinados con gran parte de productos ecológicos y de larga duración que ayuden a contrarrestar el impacto que suponen. Además, de hacer un buen reciclaje de los productos que tardan más en degradarse. Poco a poco conseguiremos un mundo más sostenible."
11/05/2021,News,731,182,69,15,997,"Adiós al reciclaje en contenedores, llega a Barcelona el primer sistema de recogida de residuos puerta a puerta de bolsas con chip","Barcelona instaura nuevos sistemas de recogida de basuras en algunos de sus barrios. El próximo 24 de Mayo, el barrio de Sant Andreu del Palomar pasará a tener menos contenedores y la recogida de sus residuos será de puerta a puerta, mediante un sistema de bolsas con chip.

Alrededor de 20.000 ciudadanos pondrán en práctica este nuevo método de separación de residuos en sus domicilios. Esta norma se aplicará también a los comercios del barrio. De momento, sólo se ha aplicado en dos barrios catalanes, pero se espera que para 2025 este nuevo sistema de reciclaje se haya extendido por todo el territorio catalán. 

En Barcelona sólo recicla alrededor del 38% de sus habitantes, según informa el Ayuntamiento; y se genera una cantidad cercana a los 500 kilos de residuos al año. Este nuevo modelo ayudará a saber qué domicilios reciclan con frecuencia y tendrá una finalidad totalmente educativa. Así lo aclara Eloi Badia, Concejal de Emergencia Climática. 

Con la implantación de nuevos sistemas de recogida, se quiere acabar también con recurrentes problemáticas a las que se enfrentan algunos ayuntamientos, como la recogida de pañales. En el barrio de Sarriá ya se instauró este sistema con anterioridad y se han registrado resultados datos muy positivos.

España a la cola de Europa en políticas de reciclaje
En los últimos años España ha registrado una tendencia a la baja en sus datos de gestión de residuos y compromiso medioambiental.

Una ley aprobada en 2011 conjuntamente con instituciones europeas, obligaba a España a reciclar un 50% de sus residuos. De los cuales, apenas, se recicla un 35%.
Las autoridades ya han sido advertidas sobre su mala gestión en materia de residuos urbanos. Incluso España ha sido denunciada ante la Comisión Europea por diferentes asociaciones ecologistas por el mismo motivo. 

“España incumplió el objetivo europeo de reciclar el 50% de los residuos domésticos en 2020’’- según informa el diario La Vanguardia.

Sólo dos comunidades autónomas cumplen con los datos establecidos por la normativa: Cataluña y Euskadi. Pero aún y así, España, está muy lejos de conseguir el objetivo que se fijó en 2011 con la aprobación de la Ley de residuos. Esta problemática, se debe a una escasa legislación en las tasas de desecho y una falta de compromiso medioambiental.

Ante estos datos demoledores para España, respecto a países vecinos, el Gobierno ya trabaja en un anteproyecto de Ley de residuos. Así como, en la creación del “Impuesto verde’’. Un impuesto de 0,45 céntimos aplicados a envases de plástico de un solo uso por cada kilo de ellos consumido. De esta manera, quieren impulsar una conciencia de reciclaje y cuidado por el medioambiente entre sus ciudadanos."
29/07/2021,News,351,156,61,12,580,Apilar piedras: un peligro digital al medio ambiente,"Con la llegada del verano, crece la incidencia de una peligrosa tendencia que está destruyendo el medio ambiente e inunda las redes sociales: apilar piedras. Y aunque en algunas culturas esto puede tener una connotación espiritual, la realidad es que para el medio ambiente, puede acabar con la biodiversidad de algunas zonas naturales protegidas. 

“Hace siete u ocho años hemos visto los primeros montículos, y ahora es una explosión’’- Según informa Jaume Adrover, portavoz de la organización ecologista de Mallorca Terraferida en declaraciones al Diario La Vanguardia.

Baleares y Canarias son las más afectadas por esta nueva tendencia digital. En algunos casos, llegando a parajes protegidos como es el caso del Parque Natural del Teide en Tenerife o el Parque Nacional de Sa Dragonera en Mallorca. Pero esta moda de apilar piedras se extiende rápidamente por todo el territorio.

Una moda con efectos colaterales 
El apilamiento de piedras supone para el medio ambiente la pérdida de ecosistemas y especies, ya que de éstas tienen una función de reguladoras de humedad. Haciendo crecer plantas entre ellas y de las cuales, posteriormente, se alimentan especies. Además, actúan como microclimas para algunos ecosistemas. En lugares como Madeira (Portugal), empiezan a desaparecer las primeras especies endémicas como: la lagartija “Teira dugesii’’ por este hecho. Y flora, como la variante de musgo “Riccia Atlantica’’. 

Desde el Consejo Superior de Investigaciones (CSIC), se pide tomar medidas que no contribuyan a avivar esta nueva moda digital. El Gobierno Balear en conjunto con la Sociedad Española de Ornitología- donde la situación es ya muy preocupante-, se están estudiando planes de actuación para reducir la presión humana en determinados puntos de la isla.  En lugares como Menorca, ya existen señales que prohíben apilar piedras en zonas de costa. Y Ayuntamientos como el de Camariñas, en Galicia, han impuesto multas de hasta 6.000€ para aquellos que modifiquen el patrimonio natural del lugar. 

Otro peligro digital es hacia las estrellas de mar
Sin duda, las redes sociales, son la nueva amenaza para el medio ambiente. Pero la actividad humana no solo deja daños a nivel costero. Sino que, el deseo por conseguir una fotografía y un puñado de «likes», deja también daños, en valiosos ecosistemas marinos. Una de las especies más amenazadas por este mismo hecho son: las estrellas de mar. 

Esta especie que habita en océanos de todo el mundo y a profundidades de casi 6.000 metros, es una de las especies marinas más fotografiadas por los humanos. Sacarlas del mar supone para ellas la muerte por intoxicación. Además, investigadores marinos, advierten que, la invasión humana en zonas próximas a sus hábitats, aumenta el riesgo de muerte por estrés de las estrellas marinas. 

Expertos de la Universidad Estatal de Oregón, alertan de la importancia de no modificar los ecosistemas y sus hábitats. Ya que esto supondría graves daños medioambientales y perjudiciales para la actividad natural del planeta."
27/07/2021,News,242,84,29,0,355,"Argentina dice ""NO"" a la cría de salmones","Una ley impulsada por Pablo Villegas y aprobada por unanimidad pretende proteger los ecosistemas marinos del Canal de Beagle prohibiendo la cría de salmones. Con esto, se busca acabar con los peligros que genera la cría masiva de salmón en aguas del canal. Así, Argentina se convierte en el primer país del mundo en tomar medidas sobre esta actividad.

El Canal de Beagle se ubica en Tierra del Fuego, entre Argentina y Chile; dos territorios con políticas muy distintas respecto a la pesca de salmón. Considerado uno de los mayores sumideros de carbono, el Canal de Beagle es la zona latinoamericana más perjudicada por la cría masiva de salmones. 

Los daños que genera la cría de salmones
La cría de salmones en este sitio se lleva a cabo en grandes jaulas submarinas de dimensiones considerables – una jaula es equivalente a un campo de fútbol (120 metros de largo por 45 de ancho) y se sumerge a una altura de 15 pisos -. Esto deja grandes daños en el fondo marítimo como la alteración de ecosistemas marinos, la aparición de algas tóxicas y la muerte de algunas especies que habitan en el lugar.

Además, numerosas empresas dedicadas a la pesca de salmón también se han visto involucradas en los problemas que deja la producción de la especie con el uso indiscriminado de antibióticos para la conservación de estos. 

Esta ley supone: “Una apuesta a favor de la vida y de actividades económicas”– así lo afirma el legislador Villegas. Según informa, la aprobación de esta ley dará lugar al compromiso y la conservación del territorio. También ayudará a enseñar a las generaciones más jóvenes a respetar el medioambiente y traerá beneficios al turismo. Responsables de Greenpeace también defienden la norma y ponen de relevancia la valiosa calidad de los mares patagónicos y la función que tienen para el planeta. Chefs como Narda Lepes y Francis Mallmann ya han retirado este manjar de sus restaurantes en compromiso con la nueva ley.

Chile y la problemática medioambiental
En abril el país registró la muerte de 5.000 toneladas de salmones asociada a la sobreproducción de algas nocivas, y con ello, la falta de oxígeno en aguas dedicadas a la cría de salmones. El presidente de la asociación Salmón Chile, Arturo Clement, en declaraciones al Diario El País, niega el impacto que pueda ocasionar la producción de salmones, alegando que «El cultivo se deja descansar hasta que se recuperan los fondos marinos». 

Se estima que la cría de salmón en el país chileno genera cantidades próximas a los 5.000 millones de dólares al año y se sitúa como el segundo exportador de salmón del mundo. 

Expertos submarinistas chilenos reconocen la grave situación que la producción y pesca de salmones ha dejado en Argentina y aseguran que si Chile no aplica medidas contundentes como Argentina, verá perjudicada gravemente sus aguas y sus ecosistemas marinos."
6/04/2020,News,79,21,0,0,100,Caen abruptamente las vibraciones de la tierra,"Hace unas semanas hemos visto cómo los satélites captaban la reducción de partículas de dióxido de nitrógeno en el aire, que resultó en una mejor contaminación. Muchas cosas han cambiado desde entonces; una de ellas es que ahora también los sismólogos detectan una caída abrupta de las vibraciones en la tierra.

Thomas Lecocq, miembro del Servicio de Sismología y Gravimetría del Real Observatorio de Bélgica, declaró: “Los datos de un sismómetro en el observatorio muestran que las medidas para frenar la propagación de COVID-19 en Bruselas causaron que el ruido sísmico inducido por los humanos cayera en aproximadamente un tercio. Una reducción de esta magnitud generalmente solo se experimenta brevemente alrededor de Navidad” .

El confinamiento, la reducción en la producción, en los movimentos de los medios de transporte, y en líneas generales, en casi toda la actividad humana ha resultado en un menor ruido en la corteza de la tierra, según explica el experto.

«Así como los eventos naturales como los terremotos hacen que la corteza terrestre se mueva, también lo hacen las vibraciones causadas por vehículos en movimiento y maquinaria industrial. Y aunque los efectos de las fuentes individuales pueden ser pequeños, juntos producen ruido de fondo, lo que reduce la capacidad de los sismólogos para detectar otras señales que ocurren en la misma frecuencia» explica la revista Nature.

¿De qué manera podría afectar esto a la tierra?

Al tener la posibilidad de obtener mayor información sobre los movimientos reales de la corteza terrestre, los geólogos y sismólogos tendrán la posibilidad de estudiar la situación en su totalidad y advertir sobre cuales son los desafíos a los que nos enfrentamos. También, de planificar nuevas vías de acción.

«Si los bloqueos continúan en los próximos meses, los detectores en ciudades de todo el mundo podrían ser mejores de lo habitual para detectar las ubicaciones de las réplicas de terremoto» explica Andy Frassetto, sismólogo de las Instituciones de Investigación Incorporada de Sismología de Washington DC para Nature. Además explica que así «obtendrá una señal con menos ruido en la parte superior (de la tierra), lo que le permitirá extraer un poco más de información de esos eventos»."
10/03/0201,News,821,375,6,15,1217,Cómo adaptar tu empresa a los tiempos de la emergencia climática,"Que Greta Thunberg nos haya abierto un poco los ojos sirve, entre otras cosas, para que todos seamos conscientes de que podemos hacer algo para frenar la emergencia climática. Y está claro que las empresas también deben subirse al tren de esta lucha compartida y hacer lo que esté a su alcance para convertirse en una empresa sostenible. ¿El objetivo? Tratar mejor a nuestro planeta.

¿Qué puede hacer tu empresa para sumarse al cuidado de la tierra? Entrevistamos a Miguel Fresneda, CEO en Woffu, para que nos cuente cómo abordar este reto desde el departamento de Recursos Humanos de tu organización y conseguir una empresa sostenible.

La documentación: toda en digital y en un mismo lugar
El Fondo Mundial para la Naturaleza (WWF) indica que el uso de papel puede reducirse al menos un 20% en todas las oficinas. 

Muchas veces se utilizan folios que gozan de un solo minuto de vida útil y probablemente sean susceptibles de pasar al formato digital. 

¿Cuál es la propuesta de Woffu?

“Desde Woffu colaboramos con nuestros clientes en su digitalización. Además de ser una solución enfocada al registro de la jornada laboral, a la gestión de turnos, y a la organización de vacaciones y permisos de ausencia, Woffu también es útil para gestionar la documentación interna. A través de esta funcionalidad los empleados y profesionales del departamento de RRHH pueden compartir y firmar documentación. De esta manera la documentación queda almacenada en un mismo lugar, se puede compartir fácilmente y está disponible para descargarse en cualquier momento y desde cualquier lugar”. 

Teletrabajo como premisa 
¿Es el teletrabajo una tendencia en sus clientes?

“Cada vez son más las empresas que se lo plantean como un “camino de no retorno” dado que los beneficios son múltiples. El 70% de las emisiones de CO2 se generan en las ciudades. Gran parte de estas emisiones son responsabilidad directa de los vehículos que usamos para desplazarnos hasta nuestros puestos de trabajo. Implantar el teletrabajo aporta múltiples ventajas y lo hemos podido comprobar este año. La más relevante es la reducción de la huella de carbono (indicador ambiental que pretende reflejar la totalidad de gases de efecto invernadero (GEI) emitidos por efecto directo o indirecto de un individuo). Evitando los desplazamientos, dejamos de emitir gases nocivos para la atmósfera”. 

“Woffu es la solución que hace compatible el teletrabajo con el buen funcionamiento de la empresa. Los trabajadores son capaces de registrar su jornada laboral a distancia controlando su jornada laboral y su derecho a la desconexión digital. Por otro lado, el departamento de RRHH puede obtener informes a medida de rendimiento, presencias, ausencias o vacaciones, sin importar que los empleados estén trabajando desde casa o físicamente en la sede de la empresa” añade Miguel Fresneda, CEO de Woffu.

Los procesos de selección, a distancia
Muchos procesos de selección debido a la pandemia han debido de ser no presenciales, ¿Creeis que esto es algo sostenible a largo plazo?

“No es necesario que sean todas las etapas de un proceso de selección de personal. Hay un alto porcentaje de todo este proceso que sí se puede hacer a distancia. Implantar entrevistas virtuales ayuda a las empresas a ser más eficientes. Las videoconferencias son un recurso interesante para ir seleccionando a los primeros candidatos. Cuando quedan pocos candidatos en Woffu preferimos conocer a las personas si es viable. Siempre hay factores que deben analizarse de manera presencial (la intuición y las sensaciones de compartir una conversación y el espacio con el candidato suelen ser decisivas).

Apostar por equipos informáticos sostenibles
Todo digital, lo tenemos claro pero, ¿Qué hay de los equipos informáticos?

“La huella que dejan los equipos informáticos que tiramos cada año es otro de los grandes problemas de la gestión de residuos que tenemos como sociedad. Los ordenadores suelen estar fabricados con metales pesados y componentes químicos nocivos para el medio ambiente, son una fuente de contaminación importante. Una opción interesante es la de comenzar a adquirir equipos de empresas que usan componentes reciclados. Otra opción es reutilizar los antiguos y reacondicionarlos. Es importante, por otra parte, que a la hora de retirar los equipos viejos, lo hagamos de una manera consciente, apostando por empresas que se dedican a reciclar componentes informáticos. Elegir software y soluciones que trabajan en la nube es una manera muy efectiva de reducir, centralizar y compartir el uso del hardware.”

Conciencia y más conciencia. ¡En verde!
¿Cómo pueden los departamentos de RRHH difundir estas buenas prácticas a toda la empresa?

“Así como líderes y activistas mundiales trabajan para crear conciencia, nosotros también debemos hacerlo en nuestras empresas. Una forma interesante podría ser la de llevar a cabo una convención o un “buzón”, en el que cada miembro de la empresa pueda aportar sus ideas”.

“Además, es imprescindible crear un manual de buenas prácticas (digital, por supuesto :-)) que ayude a concienciar a los empleados. Por ejemplo, debemos acordarnos de apagar siempre los equipos, de mantener los cables y dispositivos desconectados hasta que no se tengan que usar y configurar un sistema de ahorro energético que apague los equipos después de la jornada de trabajo. Hay que apagar las luces de la oficina en cuanto nos vayamos para concienciar a la plantilla sobre la importancia de no despilfarrar los recursos. Asimismo debemos separar y reciclar todos los residuos”. "
22/06/2021,News,409,95,40,6,550,Consumo de carne y pandemias: ¿Cuál es la relación?,"Una de las grandes cuestiones desde el estallido del COVID-19 es si el consumo de carne y las pandemias podrían estar relacionadas. El foco está en los métodos de producción en granjas industriales y el exceso en el consumo.

Los métodos de producción en granjas industriales, el consumo de carne y las pandemias podrían estar relacionados
Las granjas industriales son aquellas que producen carne de forma intensiva o masiva. Para llevarlo a cabo, modifican genéticamente el organismo de estos animales con el fin de obtener el mayor número de crías posible. Los animales son alimentados con piensos que contienen hormonas de crecimiento. Además, modifican los niveles de luz en el interior de las granjas, para conseguir que los animales permanezcan comiendo el mayor tiempo posible. 

Las prácticas en las granjas de producciones aviares, bovinas y porcinas podrían estar detrás de la aparición de enfermedades. Esto se debe a que los animales sufren estrés, deshidratación y son rociados con pesticidas y antibióticos. La composición química de estos productos permanece en los animales incluso una vez son sacrificados para el consumo.

La legislación sobre granjas industriales es un problema hambriento de soluciones
Por lo que hace a la legislación sobre la actividad en granjas industriales y sus prácticas, todavía queda mucho por hacer. Existen grandes controles de seguridad alimentaria, pero no leyes que ayuden a detener las producciones de crías intensivas de animales. En España, el pasado mes de Febrero, se establecieron nuevas normas para minimizar el impacto que deja la cría masiva de porcino y asegurar nuevas técnicas de seguridad alimentaria. 

Nuevas alternativas al consumo de carne
Numerosas organizaciones ecologistas como World WildLife o Animanaturalis, ponen en conocimiento la peligrosidad de criar animales con los métodos mencionados anteriormente. Además, hacen referencia al riesgo que supone para los humanos la ingesta de animales modificados genéticamente y las sustancias químicas que permanecen en ellos.

Las organizaciones promueven una alimentación prioritariamente vegetal. Así, no sólo se minimizaría el riesgo de nuevas pandemias con origen en los animales, sino que se contribuiría a mantener una relación más ética con ellos."
20/10/2021,News,161,47,27,12,247,COP26: ¿Qué objetivos medioambientales tiene?,"Del 31 de octubre al 12 de noviembre, se llevará a cabo en Glasgow la Conferencia de las Partes (COP). Los países que la integran se reúnen todos los años para asegurarse de que se cumplan los metas. Reducir el metano es uno de los objetivos medioambientales más clave de esta COP26. 

En el 2015, se aprobó el Acuerdo de París por la COP21 en el cual los países se comprometieron a mantener el aumento de la temperatura mundial no mayor a 1,5ºC. Un incremento de más de 1,5ºC causaría catástrofes climáticas sin precedentes, según el último informe del IPCC (Grupo Intergubernamental de Expertos sobre el Cambio Climático). Esta sigue siendo una meta primordial para la COP de este año.

Reducir el metano un 30% para el 2030
El metano es un gas de efecto invernadero, responsable de gran parte del aumento de la temperatura media mundial desde la era preindustrial, de acuerdo al IPCC. Para ser más específicos, se trata del segundo compuesto que más contribuye al calentamiento global de la tierra con un 15 %, sólo superado por el dióxido de carbono con un 76%, según aseguran desde el Registro Estatal de emisiones y Fuentes contaminantes.

La lucha contra el metano resulta fundamental para la descarbonización del sector energético. De hecho, 24 nuevos países se han adherido al compromiso mundial de reducir el metano. Estos se comprometen a alcanzar el objetivo colectivo de reducir para 2030 las emisiones mundiales de metano en al menos un 30 % con respecto a los niveles de 2020, según EFEVerde.

Objetivos medioambientales clave que esperan conseguir en la COP26
Asegurar las cero emisiones netas a nivel global para mediados de siglo eliminando el CO2. Reducir la deforestación. Reemplazar los coches de combustión por eléctricos. Fomentar la inversión en energías renovables.  

Proteger comunidades y hábitats naturales. Construir infraestructuras para evitar la pérdida de hogares y vidas. 

Movilizar dinero. Destinar al menos $100 mil millones para financiar medidas climáticas. 

Trabajar juntos. Colaborar entre gobiernos, empresas y sociedad civil, solo así se podrá hacer frente a la crisis climática. 

Este encuentro es crucial, ya que representa una guía para todos los países hacia un cambio real. Poder cumplir con el Acuerdo de París es necesario para poder hacer frente a la crisis climática que estamos viviendo."
29/01/2021,News,1133,337,21,6,1497,Cosmética con cannabis: una alternativa ecofriendly,"Considerado un negocio en auge, la implantación del cannabis en los productos cosméticos, gana cada vez más adeptos. Sus propiedades antiinflamatorias e hidratantes son el reclamo de muchos clientes.

Partiendo de la base de que, se utiliza una sustancia considerada ilegal en muchos países, puede parecer una locura introducirla en un mercado tan rentable como es, el del cuidado personal.

¿Es legal la práctica de la utilización del cannabis en la industria cosmética?

El cáñamo es una sustancia que se extrae de una variante de la planta del cannabis y en ella, se encuentra un fitocannabinoide que recibe el nombre de cannabidol, coloquialmente, conocido como CBD. Esta sustancia sólo contiene un 0,2% de compuesto. Por lo que su uso se considera legal ya que no posee propiedades psicotrópicas y no genera adicción.

Algo que sí que contiene, son propiedades curativas, a muchos niveles. Actualmente en España, es muy común el uso en productos cosméticos y es fabricado de manera sintética.

¿Por qué triunfa entre los gigantes de la cosmética?

Esta variante del cannabis utilizada para tratamiento dermatológicos posee propiedades antiinflamatorias, hidratantes y relajantes a nivel cutáneo. También está indicado para el uso y cuidado del cabello.

Estos productos están recomendados para pieles muy secas o con graves cuadros de acné o irritación por su alto contenido en ácidos grasos como Omega-3 y Omega-6. Además, acelera los procesos de curación, cicatrización y recuperación de la piel. 

Diversos estudios han demostrado que las propiedades antioxidantes del CBD, actúan como barrera y combaten los efectos que la contaminación ambiental puede dejar en la piel.

El camaño tiene , por supuesto, un papel medioambiental positivo

El cáñamo industrial, se ha convertido en los últimos años en reclamo de muchos sectores (independientemente del cosmético) por su versátil utilidad. 

Reduce la huella de carbono: Es una planta que se puede cuidar sin el uso de pesticidas y es capaz de absorber hasta 22 toneladas de carbono procedente de la atmósfera por hectárea. También es capaz de regenerar terrenos y proteger la erosión de los mismos.
Creación de bioplásticos: La celulosa es uno de los materiales más abundantes de nuestro planeta. Y la encontramos en, papeles y plásticos. Gracias al cáñamo y su alto porcentaje en celulosa (entre 60 y 70%), se pueden crear nuevas variantes de este material. Una de las variantes más relevantes se encuentra en la microfibra de celulosa. Un material utilizado para la formación de nuevos plásticos y materiales muy absorbentes. Estos materiales, son incluso, capaces de absorber derrames de petróleo. Numerosas empresas ya apuestan por el cámaño para la produccióon de bioplásticos como alternativa a los compuestos plásticos que contaminan el medio ambiente.
Biocombustibles: La semilla del cáñamo, posee hasta un 35% de aceite, lo que podría traducirse como, un combustible con mucho rendimiento. Algunos de estos ejemplos, los encontramos en el biodiesel y el etanol."
2/03/2020,News,88,52,0,18,158,Demorarse menos en elegir la serie reduce el impacto ambiental,"¿No sabes qué serie ver? Es normal. Según un informe de la consultora Nielsen, dependiendo de nuestra edad podemos perder entre 5 y 9.5 minutos en promedio en elegir qué contenido ver en una plataforma de televisión. 

La experiencia del usuario sigue siendo prioridad en la lista de objetivos de las plataformas televisivas y aplicaciones. Esto es tan cierto como lo es que cada vez hay una mayor oferta de contenidos -aunque creamos que lo hemos visto todo- y que las exigencias de los espectadores son cada vez mayores. 

La semana pasada Netflix sumó un menú de recomendaciones de los programas más populares en cada país. Esta nueva sección tiene por objetivo, según ellos, ayudar al espectador a elegir más rápidamente o a no abandonar. 

“Un adulto medio estadounidense dedica unos 7,4 minutos al día a tomar la decisión de qué ver en los servicios de streaming. Eso supone 45 horas al año decidiendo. La cifra varía en función de la edad: los adultos jóvenes (entre 18 y 34 años) invierten 9,4 minutos de media, mientras que los de 35 a 54 años aguantan 8,4 minutos navegando entre el contenido. Los mayores de 55 años, en cambio, son los que menos paciencia tienen y abandonan tras cinco minutos. Después de ese tiempo, el 21% de los usuarios se marcha sin haber elegido nada, y el 58% de los encuestados aseguró que lo más probable es que, si no encuentra nada que le atraiga, termine sintonizando uno de los canales tradicionales” explica Natalia Marcos en El País. 

La paradoja de la elección 

Peter Kastsings, vicepresidenta de audiencia de la consultora mencionó entre sus conclusiones del informe la paradoja de la elección. Ésta, obra del psicólogo Barry Schwartz, explica que el ser humano suele estar menos satisfecho con las decisiones que toma en la medida en que tiene más alternativas para elegir. Esta teoría señala consecuencias como la sensación de parálisis, menor satisfacción con la elección, frustración, mayor sentimiento de culpa. 

A todas ellas, podemos añadir el impacto ambiental que genera nuestra indecisión. 

Un análisis de Shift Project declaraba en julio del 2019 el impacto no sustentable y creciente del streaming. El reporte decía que éste fue responsable de 300m de toneladas de CO2 en 2018, lo cual era equivalente a las emisiones producidas por Francia. 

A raíz de este reporte, surgieron una serie de notas, entre ellas “¿Cómo los videos de gatos pueden resultar una pesadilla para el cambio climático?”. 

Recientemente, un análisis de la Agencia de Energía Internacional expuso que las suposiciones de las emisiones producidas por streaming eran exageradas. También, que el impacto climático relativamente bajo se debe a rápidas mejoras en la eficiencia energética de centros de datos, redes y dispositivos. Pero la disminución de las ganancias de eficiencia, los efectos de rebote y las nuevas demandas de las tecnologías emergentes, incluida la inteligencia artificial (IA) y la cadena de bloques, aumentan las preocupaciones sobre los impactos ambientales generales del sector en las próximas décadas.

Lo cierto es que, el uso de streaming está creciendo rápidamente alrededor del mundo y que estos servicios consumen energía y emiten carbono. Pero el impacto continúa siendo relativamente modesto si es comparado con el producido por otras actividades. 

¿Qué solución encontramos? Tal vez sea volver a las recomendaciones de boca en boca, mientras aguardamos los nuevos cambios en las plataformas. "
30/08/2021,News,831,214,52,3,1100,El hundimiento del barco X-Pearl causa un desastre ecológico en Sri Lanka,"El buque, que contenía alrededor de 1.500 contenedores con materiales plásticos y sustancias químicas, ha dejado las costas del oeste índico sumergidas en una profunda crisis medioambiental de la que tardará en recuperarse. 

‘‘La tripulación detectó una fuga en un contenedor de ácido nítrico, pero ningún puerto pudo solucionar el problema”.

Según informa el diario La Vanguardia.

El navío con ruta hacia Colombo, registró el 11 de mayo una fuga de este material altamente contaminante, después de partir del puerto de Dubái. Pese a que la tripulación advirtió sobre la fuga, los puertos de Qatar y Surat, se negaron a brindar asistencia por las consecuencias que esto pudiera dejar en sus costas.

El buque acabó incendiándose a causa de la fuga. Después de dos semanas sin poder controlar el fuego, acabó hundiéndose en la costa de Negombo, al oeste del país. Esto agravó aún más la situación, ya que todas las sustancias que contenía acabaron derramadas en el mar.


Vídeo de La Vanguardia

Una gran cantidad de materiales contaminantes fueron arrojados al mar en Sri Lanka
Un total de 80 contenedores con materiales contaminantes como plomo, mercurio y sosa cáustica quedaron a la deriva de las costas del océano índico. Los expertos hablaron de una posible ‘‘sopa tóxica’’, debido a la magnitud y peligrosidad de los vertidos que se pudieran producir. 

Aparte de sustancias químicas, también cayeron una veintena de contenedores con plásticos dedicados a embalajes. Las autoridades del país han prohibido las actividades de pesca en zonas próximas a los 80km. Toneladas de bolas de plástico inundan día tras día las costas meses después del hundimiento del navío. 

Toda la flora y fauna han quedado desintegradas por el vertido de los ácidos que transportaba el buque en su interior
Meses después del accidente, el Océano Índico sigue sufriendo las graves consecuencias de los vertidos provenientes del X-press Pearl. Se registran muertes de especies marinas por encima de la media. En los últimos meses, el desastre marino de Sri Lanka deja un balance de 200 tortugas, una veintena de delfines, toneladas de especies pequeñas de peces y cuatro ballenas muertas. 

Expertos en educación medioambiental afirman que un desastre de semejante magnitud dejará el fondo marino dañado durante décadas. El gobierno del país asegura que ya trabaja en diferentes planes de actuación para mitigar los daños a medio y largo plazo."
24/04/2020,News,209,53,0,15,277,Desinfectantes: nuevo riesgo para la salud humana y ambiental,"Mientras en el exterior se registra una de las caídas de la contaminación atmosférica más importantes de la historia, en el interior de nuestros hogares el aire resulta estar más contaminado.

El sobreuso de desinfectantes en hogares puede afectar a quienes se encuentran allí. “La mayoría de estos productos libera compuestos tóxicos, perjudiciales para la salud”, expresa Carlos de Prada, responsable de Hogar sin Tóxicos de la Fundación Vivo Sano. Por lo tanto, para evitar los efectos perjudiciales, el experto “recomienda ventilar muy bien tras su uso”.

La falta de determinados productos lleva a las personas a generar mezclas perjudiciales para la salud
Otro aspecto fundamental a tener en cuenta vinculado a los productos de limpieza es evitar la mezcla de los mismos. De esta forma se previenen eventuales intoxicaciones en los hogares. Durante marzo y las dos primeras semanas del mes de abril, los médicos del Servicio de Información Toxicológica (SIT) en España han atendido 11.337 consultas telefónicas. El aumento de llamadas durante el mismo periodo del año anterior fue de 1655. Se puede establecer una relación directa entre el aumento de llamados y la pandemia actual, ya que 1846 de los mismos estaban relacionados con intoxicaciones vinculadas al uso de lejías y otros desinfectantes.

El uso excesivo de desinfectantes afecta negativamente al medio ambiente
Frente al aumento del uso de estos productos claro está que “de una forma u otra estos acabarán en los desagües” obteniendo así aguas contaminadas, recalca Coldo Hernández, portavoz de campaña de tóxicos de Ecologistas en Acción. Lo que todos deben saber es que “utilizar una mayor concentración de desinfectantes no se va a conseguir una mayor desinfección”. El resultado será poner en riesgo la salud del hombre y del medio ambiente. 

No por el cuidado del ambiente se busca desalentar el uso de estos productos, por el contrario, se comprende la funcionalidad y vitalidad en estos tiempos. La solución es utilizar estos productos en la limpieza de los hogares de forma responsable, en la medida necesaria evitando los excesos. Con respecto a la salud, es fundamental ventilar abundantemente los espacios luego de la desinfección y “actuar con prudencia y sentido común siguiendo las instrucciones del Ministerio de Sanidad”, tal como recomienda Hernández."
22/04/2020,News,65,21,0,6,92,"Día internacional de la Madre Tierra, en un contexto que dejará de ser único","Este año, el Día Mundial de la Tierra cumple 50 años. Y esta celebración llega en un momento que consideramos único y particular, pero que puede no serlo.

Cuando entendemos a la tierra como algo separado y distinto a nosotros es que se nos presentan crisis como la que estamos viviendo actualmente, para demostrarnos una vez más la relación íntima entre salud humana, animal y ambiental.
De acuerdo con PNUMA (Programa de las Naciones Unidas para el Medio Ambiente), una nueva enfermedad infecciosa emerge en los humanos cada 4 meses. De estas enfermedades, el 75% provienen de animales. Esto se debe a la desprotección y guerra que presentamos constantemente a nuestro ecosistema.

El cambio climático, los cambios provocados por el hombre en la naturaleza, así como los crímenes que perturban la biodiversidad, como la deforestación, el cambio de uso del suelo, la producción agrícola y ganadera intensiva o el creciente comercio ilegal de vida silvestre, pueden aumentar el contacto y la transmisión de enfermedades infecciosas de animales a humanos (enfermedades zoonóticas) de acuerdo a las Naciones Unidas.

¿Por qué se celebra hoy el día de la Madre Tierra?
El senador estadounidense Gaylord Nelson en 1970 convocó a una manifestación a la que asistieron alrededor 20 millones de personas para La Organización del Día de la Tierra.
Ese mismo año, a finales, se creó la Agencia de Protección Medioambiental de los EEUU (EPA). Este organismo dio además origen de las organizaciones públicas para la protección del medio ambiente. Dos años después de la primera manifestación se realizó la Cumbre de la Tierra en Estocolmo, con el objetivo de sensibilizar a los líderes mundiales sobre los problemas ambientales. En el 2009, la ONU proclamó el 22 de abril como Día Internacional de la Madre Tierra.

El objetivo de la Cumbre de la Tierra en Estocolmo continúa vigente. Actualmente, La Conferencia de las Naciones Unidas sobre Cambio Climático es uno de los eventos más relevantes para combatir la emergencia climática. La edición 26 queda suspendida hasta el 2021 en la ciudad de Glasgow, Escocia, como consecuencia de la crisis sanitaria Covid-19.

Queda, para quienes luchamos por políticas más justas con la Tierra, la esperanza de que este aplazamiento de la COP no procastine las medidas que según esta misma organización hay que tomar «YA». De la misma manera, que las políticas tomadas para palear la crisis sanitaria actúen a favor del medio ambiente."
16/12/2019,News,41,18,0,6,65,Duras críticas a la Cumbre del Clima,"Con casi dos días de retraso, la Cumbre del Clima finalizó en Madrid con los objetivos propuestos para su próxima edición en Glasgow el año próximo.  

Según los expertos, se cerró sin lograr el objetivo inicial: alcanzar un acuerdo para regular los mercados de CO2 y evitar que la temperatura supere los 1,5 grados este siglo, según lo establece el Acuerdo de París.

A pesar de que se asignaron mediadores con el fin de agilizar las negociaciones, éstos sólo han conseguido exigir esfuerzos más ambiciosos contra el cambio climático. Tras una última larga jornada de escritos y borradores, se firmó este acuerdo que mira al año siguiente y fue llamado “Chile-Madrid. Tiempo de Actuar”.


Cumbre climática
¿Por qué no se ha podido llegar a un acuerdo? Carolina Schmidt, la ministra chilena de Medio Ambiente, declaró que estuvieron cerca, pero no se ha podido redactar el texto consensuado sobre el artículo 6 del Acuerdo de París que trata sobre los derechos de emisión de dióxido de carbono entre países y empresas. El por qué sigue incierto.
Pero según El País, ésta COP estaba basada en dos objetivos: “uno político -lograr que los países se comprometan a presentar planes de recortes de emisiones más ambiciosos- y otro técnico: culminar con el desarrollo del Acuerdo de París”. La importancia del artículo 6 reside en que es el único dentro del Acuerdo que involucra directamente a los sectores privados.Tal vez ésta sea la respuesta. 

Según la  BBC, “el problema, no obstante, es que no todos los países se plegaron a este compromiso. Entre ellos, Estados Unidos, China e India, grandes emisores de gases de efecto invernadero”."
2/06/2021,News,441,129,27,9,606,Economía circular y descarbonización: las metas para España 2050,"Hace unos días el Congreso aprobó la Ley de Cambio Climático y Transición Energética. La finalidad de esta Ley es conseguir que España elimine casi por completo para mediados de siglo los Gases de Efecto Invernadero. Así, el país buscará tener un modelo de Economía circular y su descarbonización. 

Estos objetivos coinciden con las advertencias ya realizadas en el Plan Verde Europeo y la Estrategia Europea de descarbonización a 2050. Muchos sectores han tildado a la Ley de “poco ambiciosa”. Según la Agencia EFE, el ecologista Juan Antonio López Uralde la describe como “muy valiente y esperanzadora”.

Muchos de estos gases se producen de forma natural. Sin embargo, la actividad humana genera un exceso de ellos que contribuye al Calentamiento Global. La producción y el transporte de energías no renovables, el método de producción ganadera y, la mala gestión de residuos, son los mayores responsables del Cambio Climático.

La Economía Circular garantiza el equilibro entre los factores económicos, sociales y ambientales
El Informe de Economía Circular en Acción, la alianza de Empresas y otras organizaciones empresariales proponen entre otras cosas, fomentar la reutilización y reparabilidad de los productos. También, incorporar materiales reciclados, y la transformar residuos en recursos.

Por su parte, la Estrategia Española de Economía Circular (EEEC), espera para el 2030 reducir un 15% la generación de residuos, incrementar la reutilización de los mismos y mejorar un 10% la eficiencia en el uso del agua, entre otros objetivos.

Se deberá optar por la descarbonización, e impulsar las energías renovables
Según la Ley, al terminar la próxima década, el 35% del consumo de energía deberá ser renovable.

Una de las opciones que se contempla es la electrificación del transporte, pero esa energía que se utilizará también deberá ser sostenible. Se espera que para el 2030 al menos el 70% sea renovable y antes del 2050, 100% renovable. También fomentará el compartir vehículos entre particulares.

Está latente la obligación de cambiar la forma de generar la energía. Cómo nos movemos, producimos y consumimos. Llegar a la neutralidad climática en 2050, no solo está en manos del Estado y las grandes empresas (gran parte sí), sino en el compromiso de los ciudadanos para lograrlo."
23/04/2020,News,47,12,9,3,71,El 2020 también podría ser el año más cálido registrado,"Este año no solo hemos sufrido la llegada de una pandemia, con efectos negativos para la salud humana y un tanto positivos para la del medio ambiente. También, se esperan hitos en relación al clima. 

Los primeros tres meses del 2020 fueron los segundos más cálidos en la historia. En primer lugar continúa siendo el primer trimestre del 2016; el año más cálido registrado hasta el momento. Los últimos 12 meses también estuvieron -por poco- empatados en el período de 12 meses más cálidos registrado. Las temperaturas de la superficie del mar casi récord han provocado una extensa decoloración de los corales durante el verano del hemisferio sur. Así, este año se perfila para mantenerse en segundo puesto. 

Según un informe de Carbon Brief, esto es particularmente notable, porque es probable que El Niño / La Niña desempeñen un papel escaso o nulo en el aumento de las temperaturas anuales; siendo que fueron la causa directa de las altas temperaturas del 2016. 

Detrás de los objetivos
Las temperaturas globales se están presentando en o por encima del nivel proyectado por el Panel Intergubernamental para el Cambio Climático IPCC de 2013. También, el nivel del mar continúa creciendo. Según el informe, debido al derretimiento de los glaciares y de la expansión del agua a medida que se calienta. 


* La tabla muestra cómo las temperaturas hasta la fecha se comparan con años anteriores en el conjunto de datos de la NASA. Esta además muestra la temperatura del año hasta la fecha para cada mes del año, desde enero hasta el promedio anual completo. Fuente: Carbon Brief

Pronósticos para el resto del año
Los diferentes grupos que trabajan para realizar estos informes adelantan que si los valores de este trimestre terminan siendo los representativos de todo el año, el 2020 se establecerá como el nuevo año más cálido. Sin embargo, es probable que las temperaturas globales no sean tan cálidas durante el resto del año, en parte porque las temperaturas globales son más variables durante el período de octubre a marzo que el período de abril a septiembre debido a los eventos de El Niño que tienden a alcanzar su punto máximo en invierno.

El Niño y la Niña
Se trata de un fenómeno climático que forma parte de un ciclo natural-global del clima que cuenta con dos extremos; el cálido (El Niño) y el frío (La Niña). Estos eventos se caracterizan por ser fluctuaciones de temperatura entre el océano y la atmósfera en el Pacífico tropical. Además son el principal impulsor de la variación de año a año y de la tendencia a largo plazo del calentamiento de la superficie. La mayoría de los pronósticos para El Niño / La Niña sugieren que las condiciones neutrales persistirán durante el resto de 2020. "
28/06/2021,News,329,56,73,21,479,El calentamiento global en España se acelera,"El calentamiento global cobra fuerza en España. Así lo demuestra el último Informe del Estado del Clima de 2020, presentado en Mayo por la Agencia Estatal de Meteorología (AEMET), el cual registra unos datos tan alarmantes que lanza una advertencia de actuación urgente sobre diferentes cuestiones medioambientales si no se quiere llegar a unas consecuencias irreparables a finales de siglo.

Los datos aportados por la Agencia indican que la temperatura en España podría crecer hasta 5ºC, a causa del calentamiento global, si se siguen registrando datos como los de 2020. El país ya acumula un incremento de 1,3ºC en los últimos 60 años. Esta diferencia acumulada podría ser la causante de algunas catástrofes climáticas dadas en 2020.

Una España más cálida
El informe señala al 2020 como el año más cálido con diferencia desde que se registran datos sobre la actividad climática. Sólo el año 2017 registró unas temperaturas similares a las del pasado año.

Se estima que la temperatura media actualmente registrada es de 14,8 ºC, superando por 1 ºC la temperatura media de referencia. El portavoz de AEMET, Rubén Del Campo, advierte que si los datos no mejoran en los próximos años, la crisis climática en el país se habría acelerado todavía más hacia el año 2050. 

Las superficies marinas también se ven afectadas por el calentamiento global
Este mismo informe también pone de manifiesto la problemática que atraviesan las aguas marinas. Según datos de la misma Agencia, la temperatura de las aguas ha incrementado hasta 0,5ºC su temperatura habitual. La continuación de esta tendencia puede ser un problema, ya que un aumento de temperaturas en los océanos puede favorecer la aparición de agentes patógenos que destruyan ecosistemas marinos y la aparición de lluvias torrenciales devastadoras. 

Tendencia a catástrofes climáticas
El Secretario de Medio Ambiente advierte de las consecuencias de la explotación de los recursos naturales por parte del hombre como principal factor causante de catástrofes climáticas. Uno de los grandes avisos que el planeta ha dejado durante 2020 han sido los repetidos episodios meteorológicos que han dejado a España bajo emergencia climática en este último año. En enero, ‘Gloria’, una borrasca de lluvias torrenciales durante tres días. En febrero, Canarias se enfrentó a polvo en suspensión proveniente de África. Y en los meses de verano, tres grandes olas de calor azotaron el país, no habiéndose registrado unas iguales desde el año 1975.

Beatriz Hervella, también portavoz de AEMET, advierte de la importancia de cuidar tanto la superficie terrestre como la marina. Y pone encima de la mesa las graves consecuencias que puede tener para los humanos enfrentarse a situaciones climáticas de semejante índole."
19/03/2021,News,373,65,6,15,459,El coronavirus trae beneficios ambientales significativos,"Mientras el coronavirus se propaga rápidamente sobrepasando fronteras alarmando a al menos 58 países, desde el punto de vista ambiental se predicen beneficios significativos.

Las emisiones de CO2 podrían descender notablemente a causa del virus. Ésta sería la primera caída desde 2008. Los vuelos cancelados y las fábricas cerradas son la clara causa de ello.
Particularmente en España, José Santamarta, economista y responsable del informe sobre la evolución en 2019 de las emisiones del Observatorio de la Sostenibilidad, señala que “el coronavirus tendrá mucho impacto en las emisiones de España”. La práctica de eliminación del carbón para generar electricidad durante 2019 fue determinante para lograr una reducción del 5,8% de las emisiones en España el año pasado respecto a 2018. “Pero el efecto del coronavirus sobre las emisiones del país será mayor que el del carbón este año”, prevé el experto.

Los combustibles fósiles, principales responsables de las emisiones de gases de efecto invernadero, continúan siendo el motor que impulsa la economía mundial.

La ecuación es simple: si la economía se congela, como ocurrió en China e Italia con las medidas de contención adoptadas, cae el consumo de energías fósiles y como consecuencia, disminuyen los gases contaminantes expulsados a la atmósfera que contribuyen al cambio climático. Los datos actuales de reducción de las previsiones de crecimiento mundial indican que el 2020 finalizará con un descenso de las emisiones respecto a 2019, según el director ejecutivo del Global Carbon Proyect, Pep Canandell.

China, país que representa el 25% de las emisiones globales, redujo en al menos un 25% sus emisiones. El brote comenzó a fines de diciembre y condujo al cierre de fábricas y comercios,sumado a las restricciones de viaje impuestas para enfrentar la epidemia.

Las emisiones globales durante el período de diciembre 2019 a febrero 2020 fueron 6% menores a las emisiones durante el período entre diciembre 2018 a febrero 2019. 
Imágenes satelitales de la NASA muestran esta drástica caída en las emisiones gaseosas adversas. La reducción de la contaminación por dióxido de nitrógeno (NO₂) fue identificada por primera vez en Wuhan, el epicentro del brote, y luego extendida por toda China.  Estas imágenes comparan las concentraciones de NO₂ para los periodos entre el 1 y 20 de enero, antes de que se impusiera la cuarentena en Wuhan y otras ciudades, y del 10 al 25 de febrero, una vez adoptadas las medidas.

De todos modos, un artículo publicado en el medio británico especializado Carbon Brief advierte que se trata de una caída temporal y plantea el interrogante sobre si la disminución será compensada o revertida superada la crisis.

Gases de efecto invernadero en España
Desde el 2007 España ha logrado reducir las emisiones de gases de efecto invernadero de forma paulatina. En 2005 entró en vigor el Protocolo de Kyoto, a pesar de haber sido firmado en 1997. Este mecanismo internacional tiene por objetivo hacer frente al cambio climático al reducir seis gases de efecto invernadero que causan el calentamiento global. 

Balance de emisiones en España en 2019
Una de las medidas adoptadas por la Unión Europea para combatir el cambio climático, es que todas las centrales deberán pagar por el dióxido de carbono que emitan para producir electricidad. En 2019 la utilización de carbón dejó de ser rentable ya que el precio de la tonelada emitida de CO₂ superó los 20 euros. 

Precisamente esta medida es la principal causa del descenso del 5,8% de las emisiones de efecto invernadero. En España ocasionó la falta de competitividad de este combustible fósil, según indica el informe del Observatorio de la Sostenibilidad. El estudio advierte que la caída de emisiones se atribuye “a la disminución de la quema de carbón para la generación eléctrica en un 69,4%”.

La influencia de la sociedad para disminuir las emisiones gaseosas
El alivio de la contaminación probablemente sea momentáneo y su origen proviene de una crisis sanitaria mundial. De todos modos, el brote del coronavirus generó un aire más limpio y la reducción de emisiones gaseosas que contribuyen al cambio climático. 

Probablemente la crisis trae consigo la posibilidad de generar un cambio a largo plazo en el comportamiento y en los hábitos de consumo de la comunidad global ya sea como resultado de la crisis económica o de una mayor toma de conciencia. 

Lourdes Rodriguez Frascaroli"
22/03/2021,News,2258,890,149,47,3344,El pulmón del planeta está contaminado,"Los océanos son el pulmón del planeta y de ellos depende nuestra vida. Producen más del 50% del oxígeno que respiramos anualmente, gracias al fitoplancton. Además, absorben gran parte del CO2 producido por los seres humanos; el gran mitigador del cambio climático.

Sin embargo, por la invasión del plástico en las aguas, se encuentran en grave riesgo. El material implica una amenaza directa al ecosistema y a la supervivencia de las especies que viven allí. Para la ONU, si esta tendencia continua, nuestros océanos podrían contener más plástico que pescado para 2050.

Por ello, es de vital importancia reducir el consumo y la producción del plástico que inunda nuestro planeta. A su vez, se deben tomar medidas que fortalezcan las practicas de reciclaje y se debe poner punto final al plástico de un solo uso.

El plástico, el gran responsable
Dentro de los residuos marinos, el plástico es el que tiene mayor presencia, representando más del 60% y continúa aumentando año tras año. Su mayor daño proviene de lo difícil y casi imposible de su degradación, permaneciendo intactos por muchísimo tiempo. Aquellos que se convierten en microplásticos afectan directamente a las especies marinas que los ingieren e, indirectamente, a los seres humanos, a través de la cadena alimentaria.

Según expertos del CIEL, los mares y océanos han absorbido entre un 30% y 50% del CO2 antropogénico producido desde la época industrial. El responsable es el fitoplancton, sin embargo, los microplásticos presentes en el agua son tóxicos para esta y otras especies marinas. 

Un estudio de Oceana señala que anualmente llegan al mar cerca de 34.000 millones de botellas y que son el tipo de plástico más encontrado en las playas del mundo. Con el solo aumento de un 10% de ellos en retornables, se reduciría este tipo de residuos en un 22%. 

¿Quien es el más contaminante?
Se puede establecer una relación directa entre los países de nivel alto en vías de desarrollo y su nivel de contaminación creciente. Tal es el caso de Indonesia. Según la ONU, se encuentra entre los 5 países que más contaminan los océanos con plástico (junto con China, Filipinas, Tailandia y Vietnam). 

Sin embargo, según el IPEN, los desechos plásticos de Indonesia no son propios. Los residuos son causados en distintas partes del mundo. China, país que recibía resiudos del resto del mundo, ha prohibido dichas importaciones. De esta forma, Indonesia ha duplicado su basura plástica, con las consecuentes problemáticas de salud que éstas contraen para su población.

¿Qué hacer?
La mayor parte de las veces, por su degradación, los plásticos extraídos del mar no se pueden reutilizar ni reciclar. Por eso, en su tesis doctoral respecto a la contaminación marina por plásticos, Iñiguez Cantos explica que los plásticos tienen un elevado poder calorífico y que, de esta forma, podrían ser convertidos en energía y potencialmente utilizados como combustibles. 

A su vez, las principales organizaciones de la sociedad civil dedicadas a esta problemática mundial, se han reunido y presentado el Manifiesto Azul para garantizar un océano libre de contaminación hacia el año 2030. En ella detallan e imploran la acción urgente. Además exigen a los políticos europeos que tomen el liderazgo necesario para combatir la catástrofe mundial de los océanos. Principalmente destacan los cambios a realizarse tanto a nivel terrestre como marino, una completa transición hacia la pesca de bajo impacto y que como mínimo el 30% del océano tena una protección total para el 2030."
30/12/2019,News,42,24,0,6,72,El suelo y la planta son un conjunto,"“Las previsiones de la FAO (Organización de las Naciones Unidas para la Alimentación y la Agricultura) indican que para el año 2050 la población mundial será de 9.100 millones de habitantes, frente a los 6.800 millones actuales. Esto supone un incremento del 34% para los próximos 40 años, que hará que se necesiten producciones agrícolas muy superiores a las actuales” explica Nazareth Aparicio, bióloga.


Para alcanzar este alto nivel de producciones agrícolas que requeriremos, es necesario el cambio a un modelo de producción más sustentable.
Un suelo más sano es posible, y eso queda en manos de todos. Nazareth nos explica la importancia de la fertilización natural y su funcionamiento.


“El suelo y la planta son un conjunto, y así debemos pensarlo” cuenta la bióloga. 

Cuando utilizamos un fertilizante químico, añadimos al suelo un compuesto para que la planta pueda crecer grande, pero olvidamos que estamos generando desequilibrios naturales tanto en el suelo como en la planta misma. 

Una vez que se recae en el uso de estos fertilizantes, los suelos se vuelven dependientes y a largo plazo no son beneficiosos. En cambio, utilizando abono químico estamos nutriendo el suelo. 

El estiércol es el fertilizante natural más comúnmente utilizado. El problema reside en que muchas veces puede estar contaminado por ejemplo con salmonella, o puede generar lípidos que lo contaminen. “Al final, no es un producto que esté equilibrado. Depende mucho de dónde proceda. Puede tener que ver, por ejemplo, con los medicamentos que se brindan al ganado” cuenta Aparicio. 

“Por otra parte existen el compost y vermicompost de lombriz; productos que pueden aplicarse directamente a la planta. 

Ambos son buenos, porque superan la fase del compostaje, se han eliminado los patógenos, antibióticos, y en este proceso los nutrientes acaban mejorados. 

La diferencia entre ambos es que el vermicompost, o más conocido como humus de lombriz, tiene el mismo nivel de nutrientes porque contiene mayor cantidad de microorganismos. El efecto que produce es que el suelo vuelve a tener vida. Entre otras cualidades, la planta adquiere la capacidad de defenderse de ataques externos y equilibrar el PH” según la experta, y emprendedora de la empresa Vermiduero, dedicada a la producción de abono de humus de lombriz para la agricultura ecológica. "
22/09/2021,News,406,59,24,6,495,El volcán de La Palma deja a la isla calcinada,"El volcán de la Palma en Cumbre Vieja entró en erupción el pasado día 19 de septiembre en la isla tras un seguido de pequeños movimientos sísmicos semanas anteriores. Este volcán ya ha destruido desde su erupción un centenar de viviendas, registra más de 300 explosiones y ha obligado a desalojar a más de 6.000 habitantes de la isla. 
El volcán volvió a erupcionar después de 50 años sin actividad volcánica y ya ha sido considerada como una erupción histórica por los expertos. Se estima que contiene entre 17 y 20 millones de metros cúbicos de magma en su interior y ha dejado entre 7.997 y 10.665 toneladas diarias de dióxido de azufre, según datos del Instituto Volcanológico de Canarias. Se cree que su actividad podría estar activa entre 3 y 4 semanas. 
El magma circula a una velocidad de 700 metros/hora por zonas habitadas y está generando columnas de humo de hasta 3.000 metros de altura. Esta situación ya afecta gravemente a zonas colindantes como son las localidades de Tacande y El Paraíso. Su actividad avanza rápidamente hacia el mar.
Se estima que la potencia de este volcán pueda ocasionar en el Océano Atlántico grandes explosiones y columnas de vapor, debido a la elevada temperatura de la lava (alrededor de los 1.000º), lo cual podrá ocasionar un aumento de las temperaturas marinas.
Los daños del volcán de La Palma llegan a los 400 millones de euros
Desde el CSIC, se ha informado que se llevará a cabo un estudio de cartografía para analizar las posibles consecuencias que pueda dejar esta entrada de lava en el mar. En cuanto a los daños materiales que dejará esta situación, se estima que por el momento ya se han alcanzado la cifra de los 400 millones de euros. El gobierno canario está preparando un decreto ley de urgencia para poder reconstruir las casas afectadas, según informa el medio Europa Press.
Por su parte, el Gobierno Español se ha desplazado a la zona afectada y ha pedido a las entidades bancarias que pongan a disposición de los afectados viviendas que puedan garantizar la protección de estos. Islas vecinas como Lanzarote han ofrecido ayuda humanitaria y países como Bruselas van a destinar fondos de urgencia para paliar los daños que está dejando esta situación en la isla de La Palma."
30/12/2019,News,58,50,3,12,123,Emprender sostenible en primera persona,"Nazareth Aparicio y Samuel Sanz soñaban con un proyecto propio en el que pudieran combinar sus profesiones. Ella es bióloga y él, geógrafo. 
Entre las horas libres de sus empleos como camarera y repartidor y los fines de semana, comenzaron hace tres años Vermiduero; una empresa dedicada a la producción de abono de humus de lombriz para la agricultura ecológica.


“Estábamos en una biblioteca y yo encontré un manual que nos inspiró. Forramos una caja de frutas, la pusimos en el patio de casa y empezamos a investigar. Al principio compramos solamente dos lechos, para ir probando. Queríamos ver la evolución de las lombrices fuera de los libros. Las lombrices son animales que cada dos meses duplican su población” cuenta Nazareth, protagonista de la historia y agrega: “ha sido un trabajo bastante duro, muchas horas de mover carretillas. Ahora mismo tenemos 400 lombrices y en dos meses posiblemente serán 800.


¿Cuál es el propósito de Vermiduero?

Buscamos reinventar la comercialización de fertilizantes en la comarca de La Ribera.
Nuestro trabajo se basa en la elaboración de humus de lombriz, que parte de diseñar unas condiciones específicas en las que las lombrices entren en contacto con el compostaje natural (estiércol).El material que éstas ingieren y después excretan se transforma en un fertilizante natural, rico en micronutrientes y que mejora la calidad natural del terreno. 
Tenemos la capacidad de producir unas 400 toneladas al año. Nuestros clientes principales son los viticultores, en big bag, pero también queremos vender en formato pequeño, en sacos de 40 litros.

¿Cuáles son los desafíos de emprender de manera sostenible?

Principalmente con la administración, al ser una actividad bastante novedosa en Castilla y León. En burgos no la conocían, cuando intentabas hablar con ellos te rebotaban de un sitio a otro.
Por otro lado el tema de financiación, ya que al ser jóvenes, no teníamos muchos ahorros. Empezamos con muy poquito y fue todo trabajado manualmente.
El tiempo es otro factor. Siempre trabajamos los fines de semana, pero ahora nos dedicaremos por completo. 

¿A qué desafíos se enfrentan diariamente?

Nos enfrentamos a múltiples desafíos constantemente. Emprender implica un aprendizaje contínuo. Siempre se trata de cosas que no te habías parado a pensar.Todo lo que se aprende hay que adaptarlo, reinventarlo. 

¿Hay evolución en el sector respecto a este aspecto?

A mi cada vez me llega mas información de apoyo a mujeres emprendedoras. Hace poco asistí a una charla de innovación en medio rural para mujeres, programas de mentoring y más.
Si es verdad que ahora pertenezco a este mundo, pero al principio no recibía tanta ayuda de estos sitios. Me parece muy positivo que cada vez haya más foco en el emprendimiento rural, porque hay que frenar el despoblamiento. 

¿Qué oportunidades que ven a futuro?

Ahora mismo estamos centrados en sacar esta nueva producción porque es vender o caer con todo el proyecto. A largo plazo tenemos otras ideas, queremos vender compostadores caseros de madera, producir humus líquido, crear ciclos de formación, dar charlas, talleres.
Creemos que el trabajo empieza por casa. En un hogar donde viven cuatro personas se puede reciclar el 50% de los residuos orgánicos si lo haces bien."
5/06/2021,News,537,153,59,0,749,"En el Día Mundial del Medio Ambiente, ¿Qué vas a restaurar?","Este año Pakistán será el país anfitrión en el Día Mundial del Medio Ambiente. Bajo la campaña #GeneraciónRestauración, la ONU  plantea una serie de acciones para darle una nueva vida a los ecosistemas dañados. Este 5 de Junio, se anhela que todos los ciudadanos tomen un rol más activo. 

Este año el foco está en la restauración de los ecosistemas a nivel global. Esto implica que la interacción entre todos los organismos vivos, lo creado por el hombre y su entorno, sea mejor. ¿Cómo se puede lograr? previniendo, deteniendo y revirtiendo el daño a la naturaleza.

Las acciones que el ser humano realiza día a día tienen un impacto ambiental. El PNUMA, Programa de las Naciones Unidas para el Medio Ambiente, pretende devolverle la vida a los ecosistemas degradados, cultivar árboles, más verde en las ciudades, repoblar jardines con especies silvestres o limpiar la basura de los ríos y costas.

Una guía para sanar el planeta
La ONU publicó recientemente el  Decenio de las Naciones Unidas sobre la Restauración de Ecosistemas (2021-2030). En este documento proponen una década salvar el planeta; y explica cómo ayudar a erradicar la pobreza y combatir con el cambio climático.

El éxito depende de todos y cada uno a la vez. La ONU hace hincapié en esto y para promover la acción individual se formuló una guía práctica para fomentar la recuperación de los ecosistemas. 
El foco está puesto en «tomar acciones inteligentes» , como consumir únicamente productos sostenibles y cambiar la dieta.

La restauración de sus ecosistemas será crucial para España
El país sufre de varios problemas medioambientales. La Radiografía social del Medio Ambiente de Greenpeace (2015) marca un índice de calidad ambiental. Cómo puntos negativos destacan los incendios y la deforestación, las emisiones de CO2, el uso de transgénicos y el material residual.  Si bien el informe tiene cierta antigüedad, los problemas a los que nos enfrentamos siguen siendo los mismos.

Las posibilidades de ayudar en la restauración de los ecosistemas son infinitas. Es importante que las personas asuman un rol activo. Pequeñas acciones diarias que colaboran a la salud ambiental. Si no se recuperan los ecosistemas se vuelve más difícil alcanzar los Objetivos de Desarrollo Sostenible y el Acuerdo de París. "
20/11/2020,News,183,53,15,12,263,"Energía positiva, fuente de inversión hotelera","Noruega es país pionero en la creación de Svart , un nuevo modelo de hotel basado en el autoabastecimiento y la renovación de energía. La empresa Arthic Adventure of Norway, es la compañía responsable de su desarrollo y construcción.

El proyecto cuenta con un minucioso estudio de las funciones de cada una de las estructuras presentes en el hotel. El foco está puesto en crear energía renovable que cubra las necesidades para el funcionamiento correcto del mismo. Además, sus diseñadores, también han tenido en cuenta la estéticas arquitectónicas de la ciudad de Meloy ciudad en la que estará ubicado.

Para garantizar la producción de energía renovable, contará con una estructura circular que permitirá dar un mayor rendimiento a la energía que se produce en su interior. Contará también con sistemas fotovoltaicos en la parte superior de la estructura. Éstos, serán los encargados de regular las temperaturas del interior del hotel y proporcionar, también, la luz necesaria en cada momento.

Este proyecto arquitectónico, tiene presente acercar el contacto de sus huéspedes con la naturaleza del lugar. La estructura circular se extiende desde el pie de la montaña de Almlifjellet hasta las aguas del fiordo Holandsfjorden. Esto permitirá que el huésped tenga una experiencia 360 con el entorno que lo rodea. Debido a la ubicación del proyecto, la única vía de acceso será en barco. La flota que cubrirá la ruta hasta el hotel, se caracterizará por ser de energía neutra. Y partirá desde la ciudad de Bodø.


Este nuevo concepto de hotel verá la luz en 2021. Se estima que su funcionamiento, ahorrará hasta un 85% de energía, respecto a hoteles convencionales. La capacidad de autoabastecimiento de este hotel, lo convierte en una apuesta segura de turismo sostenible. Además de, convertirse en un sistema pionero en el sector hotelero."
15/09/2021,News,359,57,17,7,440,Entra en vigor el nuevo etiquetado energético,"El pasado 1 de marzo entró en vigor el nuevo etiquetado energético europeo para electrodomésticos y recientemente, el 1 de septiembre también para fuentes de iluminación. Un sistema tachado de ‘‘estricto’’ y que dará prioridad a la eficiencia energética. Se estima que con este nuevo modelo de consumo cada europeo se ahorrará más de mil euros anuales en su factura de la luz.

Este dejará atrás las clases energéticas A+, A++ y A+++ y volverá a la antigua escala de clasificación de productos de la A a la G de mayor a menor eficiencia, respectivamente. 

El nuevo etiquetado energético supondrá un antes y un después para las emisiones de carbono en Europa
Desde el Ministerio para la Transición Ecológica y el Reto Demográfico informan que: ‘‘Todas las empresas distribuidoras tienen un plazo de 14 días hábiles para cambiar los etiquetados. De lo contrario, los productos no podrán venderse transcurridos 18 meses desde su posterior distribución’’.

Desde el mismo el Gobierno Español informan que este cambio en el etiquetado se debe a una saturación de productos de clase A+, A++ y A+++ en el mercado que causaban confusión en el consumidor. Esta situación ha llevado a la Unión Europea a visibilizar de forma más clara cuáles son los productos verdaderamente eficientes.

Este nuevo sistema también contará con la aprobación del cliente antes de adquirir un producto y saber qué valores energéticos posee. Esto se llevará a cabo gracias a un sistema de código QR en el mismo etiquetado, que permitirá dar la información energética de cada producto. De esta manera, también se quiere conseguir un perfil de cliente más comprometido con el medio ambiente.

Más eficacia, menos gasto
Una de las graves consecuencias que deja el uso desmesurado de productos no eficientes en el planeta es la huella de carbono. Además, desde que en abril se registrara uno de los mayores récords históricos jamás registrados de luz (133,26€ megavatio/hora), la importancia de vender productos más eficientes energéticamente gana fuerza. Es por ello que Europa quiere priorizar el comercio de nuevos productos que ayuden a reducir las graves consecuencias que el sector energético deja en el planeta."
8/10/2021,News,426,1188,15,0,1629,España ya tiene nombres para las nuevas borrascas,"La Agencia Estatal de Meteorología (AEMET) ha publicado los nombres para las borrascas que tendrán lugar en España durante la temporada 2021/2022. Según este sistema de nombramiento, cualquier fenómeno de considerada potencia meteorológica tendrá asignado un nombre.

Entendemos por borrascas a aquellos procesos producidos a baja presión y
transcurridos entre latitudes que oscilan entre los 30º y 60º, según informa el
medio Meteored. En Estados Unidos también se utiliza este sistema de nombramiento para los tifones y huracanes.

‘‘La finalidad de este sistema de nombramiento es ayudar a
usuarios y medios de comunicación a la divulgación de
información y alertas ante posibles emergencias climáticas’’.

Gráfico extraído de la página oficial de AEMET
Este sistema de denominar los fenómenos meteorológicos por nombres de persona está consensuado por los 4 grandes grupos europeos de control climatológico (Grupo Norte, Grupo Central, Grupo Suroeste y Grupo Oeste). De esta manera, también se contribuye a la cooperación entre países en casos de extrema gravedad meteorológica.

El sistema de poner nombres para las borrascas viene de tiempo atrás
Desde hace algunos años, las borrascas poseen nombres de persona. Es el caso de una de las más recientes en nuestro país: Filomena. Esta dejó a España, a principios de
2021, inmersa en fuertes nevadas en el interior peninsular con grandes lluvias
y fuertes vientos en zonas de costa. Este sistema de nombramiento en España, Portugal y Francia está representado por el Grupo Suroeste.

Actualmente se utilizan seis listas de nombres tanto de hombre como de mujer de manera rotativa, de modo que la lista de 2021 se utilizará de nuevo en 2027. Sin embargo, no se pueden volver a usar nombres asociados a fenómenos que fueron potencialmente devastadores para no herir la sensibilidad de la población.

Una metodología con principios religiosos
Lo que se desconoce es que los inicios de este sistema se remontan al siglo XIX, cuando
expertos meteorólogos asignaban nombres de índole religiosa a potentes borrascas que acontecían por entonces. Poco tiempo más tarde, el meteorólogo australiano Clement Waragge decidió asignar nombres de mujer a estos fenómenos potencialmente peligrosos para el medio ambiente."
19/03/2021,News,731,264,27,15,1037,"Fútbol ecológico y vegano, el primer equipo en el mundo","Forest Green Rovers, es el primer equipo de fútbol ecológico y vegano del mundo. Y está ubicado en la localidad de Nailsworth, al sudoeste del Reino Unido.

Este club, empezó a tomar conciencia ecológica en 2010, con el cambio de su dirección. Con la entrada de Dale Vince al frente de la dirección este club británico, se instauraron nuevas prácticas sostenibles en el equipo. Antes de su entrada en la dirección del club, Vince ya era propietario de empresas dedicadas a la creación de energías renovables. 

Aunque este club pertenece a la Two League Inglesa (equivalente a cuarta división) ya se ha ganado el reconocimiento de seguidores e incluso, de la misma FIFA y la ONU. Esta última, llegó a otorgarle en 2018, el premio ‘’Momentum for Change’’ por su compromiso medioambiental.

El reconocimiento de diferentes entidades, y de sus seguidores, hacen que el proyecto de Vince siga adelante a gran escala con la creación de ‘’ECO PARK’’; un estadio con aforo de hasta 5.000 espectadores, creado a partir de materiales sostenibles, principalmente de madera. Se estima que este proyecto pueda alcanzar un coste de hasta 120 millones de dólares.

Sus prácticas ecológicas van desde la arquitectura del estadio, sus prácticas de reciclaje, y las equipaciones de bambú, hasta la alimentación vegana de sus jugadores.


La economía del fútbol
Según un estudio realizado por la consultora PwC el fútbol dejó, concretamente en España, durante la temporada 2016/2017 unos ingresos que superaron la cantidad de los 15.000 millones de euros. Y supuso la creación de nuevos empleos. Fomentando así también, en hasta un 70%, la influencia positiva en las relaciones familiares.

La industria del fútbol no sólo se mueve entorno a sus partidos en los estadios. Sino que, también, promueve grandes cantidades de dinero por los visionados en televisión. Lo que supuso para La Liga, unos ingresos adicionales de 1.226 millones de euros provenientes de suscriptores de plataformas de contenido futbolístico. 

Este mismo estudio, también dice que, hasta un 78% de los encuestados reconoce el fútbol como deporte de referencia en España. Y es promotor de valores como: compañerismo, deportividad e integridad.

Su impacto medioambiental
Aunque el fútbol, como hemos visto, mueve grandes cantidades de dinero, también genera grandes impactos medioambientales. Se estima que, durante los torneos de la FIFA, se emiten un total de 2,75 millones de toneladas de este gas. Otro impacto negativo que no pasa desapercibido, es el uso de agua para el riego de campos de césped natural. Para regar una superficie de juego de estas características son necesarios unos 52.000 litros/diarios. Muchos clubes, ya han optado para sus terrenos de juego, utilizar superficies de césped artificial. Con ello, promueven el ahorro de agua. Ya que estos, sólo requieren 900 litros. 

Otro de los grandes impactos que deja la industria del deporte, en general, es la elaboración de prendas para el uso durante su práctica. Empresas como: Patagonia, The North Face o Adidas, ya se suman a la producción de prendas con materiales orgánicos que contribuyen a minimizar el impacto de gases en la atmósfera durante la producción de estas."
10/08/2021,News,171,83,59,9,322,Hawaii y Tailandia protegen los arrecifes de coral de protectores solares contaminantes,"Tailandia prohíbe el uso de protectores solares contaminantes con el fin de cuidar sus zonas protegidas de coral. El daño que dejan algunos de los componentes de estos productos ponen en peligro la supervivencia de esta especie marina; y con la llegada del turismo esto se hace notar.

La nueva medida que entró en vigor el pasado día 4 de agosto en el país asiátco, prohíbe todos aquellos productos solares que contengan los siguientes componentes: oxibenzona, octinoxato, 4-metilbencilideno alcanfor o butilparabeno. Se ha comprobado que estas sustancias producen en los corales la debilitación de las especies, la muerte de sus larvas y dificulta su reproducción.

Los corales habitan tanto en aguas superficiales como profundas. Representan el 25% de la fauna marina y precisan de aguas transparentes y libres de sustancias tóxicas para poder realizar la fotosíntesis.

En el mundo existen alrededor de 6.000 especies de corales. Pero según investigadores de la ONU, en 2050, se habrán extinguido hasta un 90% de ellas, como consecuencia de la contaminación de sus hábitats.
Este problema es de escala mundial. La Barrera del Arrecife de Belice, una reserva que cuenta con siete áreas protegidas y donde habitan más de 1.400 especies, también se ve afectada por la contaminación provocada por los protectores solares. Declarada Patrimonio Mundial, fue considerada como zona de peligro en 2017 por la UNESCO, por considerarse zona de exploraciones petrolíferas.

Ante tan alarmante situación, el Gobierno Tailandés, el cual, ya trabaja para la protección y mantenimiento de los corales desde 2011, quiere endurecer las medidas con esta nueva norma y cuidar sus zonas costeras. Aunque aún se desconoce cómo se empleará la norma en las costas del país, el gobierno, ya ha anunciado que el incumplimiento de la norma conllevará a sanciones que oscilarán entre los 2.000 y 3.000 dólares.

La prohibición de ciertos protectores solares contaminantes se instaura en el mundo
Países como Hawái ya cumplen con esta normativa desde Enero. El estado norteamericano fue el primero del mundo en implantar medidas para proteger sus arrecifes.

Este país recibe una cantidad próxima a los 10 millones de turistas al año. Y registra una cantidad próxima a las 6.000 toneladas al año de protector solar en sus costas, según informa el portal Surfer Rule.  Lo que comporta daños irreparables en los corales como su decoloración y el blanqueamiento de la especie. 

Sin duda, el turismo es una de las mayores amenazas para los ecosistemas: desechos depositados en el mar, una presión humana alarmante en ecosistemas protegidos y un mal uso de los ecosistemas en zonas turísticas están poniendo en peligro valiosas especies del planeta."
11/05/2021,News,387,49,15,41,492,"Holanda y Dinamarca están a la cabeza en políticas de reciclaje, España los sigue","Las nuevas prácticas de reciclaje de Barcelona no son novedad para algunos países que incluyen el reciclaje en sus políticas públicas. Alemania, Reino Unido o Italia son algunos de ellos. Pero si hay uno que destaca es Países Bajos.

Holanda genera 60 millones de toneladas de residuos al año. De este monto un 80% se recicla, el 18% se incinera y el 2% restante se utiliza como rellenos sanitarios. Su finalidad es evitar la contaminación de aguas subterráneas y de plásticos en sus mares.

La materia obtenida del reciclaje se emplea en la misma ciudad de diferentes maneras: 

Residuos orgánicos: Pasan a ser compost y materiales de abono para campos y parques de la ciudad. El gas desprendido durante la descomposición de estos residuos, se utiliza como combustible para los camiones de recogida de residuos urbanos.
Papel/cartón y plásticos: Nuevos productos de la misma índole.
Materiales de construcción: Entre un 85% y 95% de ellos, terminan siendo materiales para la creación de carreteras. Además, las empresas dedicadas al sector de la construcción tienen la obligación de prevenir generar residuos. 
“En 2019, Dinamarca recicló un 92% de plásticos utilizados en el país. Esto supone, un ahorro para el clima de más de 150.000 toneladas de CO2’’, según informa la revista Conde Nast Traveler.

El país ya presenta una tasa muy alta de sostenibilidad, y trabaja a la vez en un nuevo modelo de desarrollo sostenible. En 2020, la vicepresidenta de la ciudad de Ámsterdam, Marieke van Doorninck, anunciaba un modelo de economía circular impulsado por Kate Raworth en conjunto con la Universidad de Oxford. Este nuevo sistema, ayudaría a combatir los efectos de la recesión económica de 2020 y se quieren lograr objetivos cara a 2050. Entre sus objetivos están dar una mayor durabilidad a ciertos productos y que el sector de la hostelería haga cómputo de los materiales reutilizables que usan. Además su prioridad será satisfacer las necesidades básicas de sus habitantes dentro de los límites que el planeta pueda ofrecer. 

Otros países como Noruega y Dinamarca, también trabajan en un sistema de reciclaje de en el que se intercambian desechos plásticos por descuentos en diferentes establecimientos."
16/08/2021,News,158,32,53,3,246,Los incendios arrasan en el mediterráneo,"Durante los meses de verano, las olas de calor son moneda corriente. Según la Agencia Estatal de Meteorología (AEMET), se trata de episodios de temperaturas anormalmente altas que se mantienen varios días y afectan a una gran parte de la geografía. Muchas veces son la causa de los incendios.

En las últimas semanas, una ola de calor ha arrasado en varios países del mediterráneo. Las altas temperaturas alcanzadas son la clara evidencia de una crisis climática latente. 

El cambio climático está influyendo en la frecuencia, la duración y la intensidad de los incendios.

Según investigadores del IPCC, el clima global está cambiando rápidamente, y las temperaturas del planeta se están incrementando como no lo han hecho en los últimos 2000 años.

Turquía está viviendo una de sus peores oleadas de incendios con 200 focos y ya 200.000 hectáreas quemadas. Además de 8 víctimas mortales y 400 heridos. Grecia tuvo más de 80 focos en un día y se han consumido cerca de 100.000 hectáreas. “Lo de Grecia y Turquía es una nueva normalidad que vamos a ver con el cambio climático” -aseguró Juan González, especialista en cambio climático de la Complutense a El País. 

Falta un informe específico que demuestre que estos incendios se producen puramente a causa del calentamiento global
Hasta el momento no existe un estudio en concreto sobre estos fuegos. Es por eso que no se lo puede relacionar de forma categórica con el cambio climático, explican en El País. Lo que sí puede considerarse un indicador del calentamiento global son los registros excepcionales de temperaturas. Grecia ha llegado a 47º, su pico más alto de los últimos 40 años. 

Los estudios de atribución resultan costosos, por lo tanto, es difícil poder demostrar científicamente la unión entre un evento meteorológico extremo y el calentamiento climático, según dice Gonzalez.

¿Por qué es importante un estudio de atribución de eventos extremos? Para saber si el calentamiento global influye en la intensidad de un evento climático extremo. Esto puede ayudar a las personas en comunidades afectadas a desarrollar planes de recuperación para un futuro riesgo, explican de Climate.gov. 

Adaptarse a la nueva normalidad requerirá medios propios y ayuda externa
Se necesita colaboración para ponerle un freno a los incendios, no solo económico, también refuerzos como bomberos, helicópteros, etc. En el caso de Grecia, el comisario europeo de Gestión de Crisis escribió en Twitter que: “La UE está enviando capacidades de extinción de incendios adicionales a Grecia y Macedonia del Norte para apoyar la respuesta local”.

Entonces, ¿Por qué los países que suelen arder en verano necesitan de tanto apoyo externo? Es necesario hacer inversiones, por un lado un estudio para poder detectar de raíz dónde y cómo surge el problema. Además, lograr tener los medios propios para enfrentarse a los fuegos, sin depender total y exclusivamente de ayuda extranjera."
19/07/2021,News,273,92,56,18,439,Inodoro ecológico: de excrementos humanos a energía,"Un invento de una universidad de Corea del Sur convierte los excrementos humanos en energía renovable. El Instituto Nacional de Ciencia y Tecnología de Uslan ha sido el encargado de desarrollar este nuevo inodoro ecológico. 

El profesor Cho Jae-weon, inventor del inodoro, afirma que los excrementos poseen un gran valor económico y energético. Se estima que una persona, de media, puede expulsar una cantidad diaria cercana a los 150 gramos. Con ésta se pueden conseguir hasta 0,5 kilowatt-hora de electricidad. 

El inodoro descompone los excrementos en metano
Este inodoro conocido como BeeVi tiene un funcionamiento sencillo. A través de una bomba de vacío, se conecta el inodoro a un biorreactor subterráneo donde se terminan depositando las heces. Una vez que éstas se depositan en este biorreactor, los microorganismos descomponen la materia en sustancias como metano. Y este metano se utiliza posteriormente para abastecer energéticamente las instalaciones de la facultad. Con este mecanismo ya han hecho funcionar: una celda de óxido sólido, una estufa de gas y una caldera de agua caliente. 


Además, su tecnología contribuye al ahorro de agua. Mientras que un inodoro convencional gasta alrededor de 6 y 16 litros por cada descarga, BeeVi no requiere de recursos hídricos para su uso. Todo se elimina mediante la succión que la bomba de vacío genera. 

Pero una de las grandes motivaciones de usar este nuevo inodoro ecológico es que los estudiantes del campus reciben una compensación económica por hacer sus necesidades en él. “Las heces tienen un valor precioso para producir energía”– afirma el profesor e inventor del inodoro. 

“Todo esfuerzo tiene su recompensa”
Los estudiantes reciben criptomonedas por utilizar el inodoro. La moneda digital se llama Ggool y se acumula a través de un código QR. Los usuarios pueden ganar 10 Ggool al día, que se pueden canjear en la tienda de la universidad por comida, café o libros. 

Alumnos de la universidad afirman que han roto los tabús que los temas de escatología les generaban. Y que gracias a esta invención de su profesor, ir al baño nunca había sido tan motivador."
26/10/2020,News,247,38,6,6,297,Kawah Ijen: El asombroso volcán de lava azul,"El año 2021 está dejando impactantes imágenes sobre la actividad volcánica alrededor del mundo. Pero algo que pasa inadvertido de los volcanes es que una elevada cantidad de azufre puede llegar a cambiar el color de su lava. Este es el caso del volcán de lava azul Kawah Ijen, en Indonesia.

Considerado como uno de los más increíbles del mundo, es característico por el peculiar color de la lava que produce. Cuando los gases sulfúricos entran en contacto con una temperatura del aire superior a los 360°C, se produce una reacción química reactiva. Por ello, su brillante color azul en sus riadas solo es apreciable en la oscuridad. Esto lo hace un volcán extremadamente peligroso para la población pero peculiar para investigadores y expertos.


La belleza del volcán de lava azul tiene un impacto medioambiental
Se considera un volcán altamente contaminante, no solo por las elevadas tasas de gases que expulsa, sino también por la gran cantidad de azufre que produce. Este azufre es comercializado posteriormente por empresarios de la ciudad para la producción de algunos productos usados en la vida diaria como plásticos, pesticidas, pólvora e incluso conservantes alimentarios.  

Además, la corrosividad de su lava provoca la contaminación de ríos cercanos, en consecuencia, las aguas del lugar tienen PH’s muy ácidos. Esto provoca pérdidas de terreno y biodiversidad durante los periodos de riego de los campos de cultivo y crece el número de enfermedades como fruto de la inhalación de estos gases y consumo de las aguas del lugar.

Este volcán no tiene explosiones violentas desde el año 1936, pero nunca ha dejado de tener pequeñas erupciones. Su gran actividad volcánica ha formado incluso lagos ácidos alrededor del cráter, considerados por viajeros y excursionistas como auténticos regalos del planeta.

Indonesia, tierra de volcanes
El volcán Kawah Ijen es uno de los más asombrosos del mundo por su peculiar actividad volcánica, pero lo cierto es que Indonesia es reconocida por las violentas erupciones de sus volcanes. El pasado mes de marzo, el volcán Sinabung en Sumatra estalló dejando coladas de hasta 5.000 metros de altura.

Estas grandes erupciones se deben a la predisposición geológica del territorio, así como a la actividad sísmica que se registra en el mismo. El archipiélago donde se encuentra Indonesia, está formado por 17.000 islas, que en conjunto forman el Anillo de Fuego. Lugar donde se producen el 90% de los terremotos, y lo cual, le atribuye a los volcanes de la zona una potencia superior al resto."
8/04/2020,News,67,18,0,0,85,La contaminación produce mayor mortalidad por Covid 19 y la destrucción de los ecosistemas deja lugar a nuevas pandemias,"Hacía tan solo una semana podíamos observar las vistas satelitales de cómo comenzó a reducirse la contaminación del aire en China. Estas imágenes conmovieron a quienes permanecían todavía indiferentes a la crisis climática y ecológica. 

Diversos estudios han surgido a causa de la crisis sanitaria del Covid 19 que relacionan directamente el esparcimiento del virus con la contaminación ambiental. 

“El coronavirus mata más en las áreas con mayor polución” titula La Vanguardia su última nota al respecto. Un estudio de la Universidad de Harvard ha demostrado que las zonas geográficas o territoriales con una atmósfera más contaminada son las que están registrando una mayor mortalidad. “Si no se hubieran dado estos niveles de polución históricos, la mortalidad se hubiera reducido en un 10%”, explica el estudio. 

La relación entre la contaminación y la mortalidad que produce en la enfermedad es clara. Uno de los mayores síntomas y consecuencias de la enfermedad producida por el virus es la dificultad para respirar. 
Es por este motivo que los médicos confirman que aquellas personas con enfermedades pulmonares o respiratorias previas exacerbadas por la contaminación, como el asma son más vulnerables a este virus en particular. Además, “Cuando se tienen en cuenta otras vulnerabilidades comunes en las comunidades con mala calidad del aire, como el desempleo y la falta de acceso al transporte, la superposición entre la proximidad a grandes contaminadores y el mayor riesgo de sufrir graves resultados de coronavirus se vuelve evidente” explica el periodista John Vidal en Scientific American. 

A esta conversación se sumó John Showalter, CPO de Jvion, una firma de cuidado de la salud que está contribuyendo con Microsoft para identificar las poblaciones más vulnerables en Estados Unidos. «Definitivamente existe una justificación biológica de que los peligros para la salud ambiental que conducen a afecciones pulmonares y cardiovasculares llevarían a las personas con esas afecciones a tener un mal desempeño durante un brote de COVID-19».

La destrucción de los ecosistemas es el escenario perfecto para las pandemias
En paralelo a las investigaciones de la vacuna y estrategias para combatir el virus, se están investigando cuales son los factores que nos trajeron hasta este punto. Los expertos explican que continuar con un medio ambiente desprotegido, puede resultar en un mayor número de pandemias. 

“Invadimos bosques tropicales y otros paisajes salvajes, que albergan tantas especies de animales y plantas, y dentro de esas criaturas, tantos virus desconocidos”, escribió David Quammen, autor de Spillover: Animal Infections and the Next Pandemic, en The New York Times. “Cortamos los árboles; matamos a los animales o los enjaulamos y los enviamos a los mercados. Interrumpimos los ecosistemas y liberamos los virus de sus anfitriones naturales. Cuando eso sucede, necesitan un nuevo host. A menudo, lo somos”.

Kate Jones, presidenta de ecología y biodiversidad en UCL se dedica a estudiar cómo las especies en hábitats degradados portan más el virus que pueden infectar a los humanos. “Cada vez más estas enfermedades zoonóticas están relacionadas con el cambio ambiental y el comportamiento humano”

“Los sistemas más simples tienen un efecto de amplificación. Destruye los paisajes, y las especies que te quedan son las que los humanos contraen las enfermedades” declara la experta. "
30/04/2020,News,94,33,3,6,136,La crisis como oportunidad para reinventarnos modo verde,"“Weiji” es “crisis” en chino. “Ji” significa “oportunidad”. Podemos estar de acuerdo en que de esta crisis sanitaria algo positivo podemos tomar, y esto es la oportunidad de cambiar muchos procedimientos o prácticas en todos los sectores que no son favorables al medio ambiente. En líneas generales, las nuevas medidas de precaución sanitarias que debemos tomar implican nuevos hábitos de movilidad y consumo. 

La decisión de optar entre una mascarilla reutilizable y una desechable es traspolable a todo tipo de decisiones nuevas que se tomen. 
Aviación, ocio y turismo: los sectores más afectados económicamente
La aviación, el turismo y el ocio, son, de acuerdo al último informe de Brand Finance, los sectores con mayores pérdidas económicas, siendo la aviación el sector que se lleva el primer puesto. La pérdida de la esta industria ya alcanza los 185.000 millones de euros y Boeing ha perdido 55.000 millones en asistencia a los fabricantes aeroespaciales. 

Se estima que la economía global perderá alrededor de un billón de euros como resultado del Coronavirus según este mismo informe. A su vez, el Producto interior bruto se hundió un 5,2% entre enero y marzo en españa, siendo ésta la mayor caída del siglo. 

Está claro que las afectaciones a la economía local y global son severas y que se requerirá de un amplio paquete de estímulo económico. La cuestión continúa siendo si éste se dará en apoyo a una economía neutra en carbono, como fue prometido por Connie Hedegard, la primera comisaria europea de Acción Climática. 

Este plan requeriría cada año cientos de miles de millones de euros de fondos públicos y privados y requerirá que los recursos públicos respondan a los objetivos del “Pacto Verde”, creen puestos de trabajo y den impulso a la actividad económica, según Peter Vis, exjefe de gabinete de Hedegard. “Lo que se busca son inversiones productivas, orientadas al futuro, que sean compatibles con la neutralidad en carbono para mediados de este siglo”, explica”. 

Reinventarse ecológicamente 
¿De qué manera y qué oportunidades tienen estos sectores de reinventarse ecológicamente? 

En el caso de la aviación, apostar por combustibles sintéticos provenientes de energía renovable sostenible. El cambio de carburantes es, sin duda, urgente y más caro (hasta 4 veces según los expertos), pero depende de las presiones políticas y económicas que éste sea el nuevo y único camino posible. 

Ya circulan en los países que comienzan la #desescalada, las guías para las buenas prácticas en el sector hotelero y de la restauración. 

Estas medidas recomendadas incluyen consejos de limpieza y de actuación, pero no mencionan el tipo de materiales que se deben utilizar. Se hace referencia constante al tipo de materiales desechables, los cuales impactan negativamente en la ecología. Guantes, mascarillas, recipientes para alimentos, vajilla, en muchos casos podrían ser reutilizables o “plásticos” o materiales biodegradables. 

“El coronavirus y el confinamiento han tenido un impacto “absolutamente inusual” en el mercado de combustibles, que ha provocado un ahorro en las importaciones y la salida de divisas, con la consiguiente parada casi absoluta del automóvil, del sector de la aviación y una disminución de la demanda energética que ha reducido la quema de gas”, explica a Efe Fernando Prieto, director del Observatorio de la Sostenibilidad. Añade, que estos beneficios serán puntuales “mientras no se adopten medidas estructurales para mantener la reducción de las emisiones contaminantes”. "
23/04/2021,News,264,109,15,6,394,La economía creativa reconoce a la cultura y sostenibilidad como bien esencial,"La UNESCO, declaró el 2021 como el “Año Internacional de la Economía Creativa”. Este tipo de economía ya vigente desde 2013, ha ganado fuerza en 2021. Esta entidad prevé resultados positivos con este modelo para algunos sectores duramente castigados por la crisis sanitaria, especialmente el sector cultural.

Aunque paradójicamente, ha sido uno de los sectores a los que más hemos recurrido durante los periodos de confinamiento alrededor del mundo, también ha sido de los más castigados. Los cierres de instituciones creativas y la suspensión de conciertos, entre otros, deja al sector inmerso en una profunda crisis. 

Apoyo a la diversidad cultural y la creatividad
Este tipo de economía, también conocida como Economía Naranja, abarca y reconoce a los sectores de propiedad intelectual y conocimiento. Se trata de un modelo de desarrollo donde la diversidad cultural y la creatividad, son un pilar de transformación social y económica de un país. 

El sector cultural deja alrededor de un 3% del PIB mundial. Representa además un total de 30 millones de empleos alrededor del mundo. Las empresas dedicadas al sector creativo o cultural promueven cantidades billionarias de dinero según la Unesco.
¿Cuáles son sus beneficios?
En muchos lugares del mundo, este modelo económico, ya se aplicaba con anterioridad a la crisis sanitaria con resultados muy positivos, uno de ellos, Colombia. Este país, fue pionero en aplicar esta economía en sus políticas gubernamentales, registrando un crecimiento en los últimos años, de empresas dedicadas al sector creativo y fomentando el desarrollo y creación de nuevos empleos.


Son 128 los países cuyas instituciones culturales continúan cerradas como consecuencia de la pandemia. 
De 60.000 museos alrededor del mundo, casi el 95% de ellos, permanecen clausurados desde que se declaró el estado de emergencia en todo el mundo, según informa el Consejo Internacional de Museos.

En España, se registra una recesión económica que hace rebajar hasta en un 75% el gasto dedicado a fines culturales. Esto supone unas pérdidas de 3.000 millones de euros respecto al año 2019, año en el cual se crearon alrededor de 700 mil puestos de empleo vinculados al sector.

“La cultura aportó al PIB en 2019 una cantidad cercana a los 40.000 millones de euros, un 3,2% del total (con las aportaciones de la propiedad intelectual incluidas)”- según informa el diario El País.

Es por eso que, la UNESCO quiere reconocer la cultura como un bien esencial, ya que aporta valores positivos para el desarrollo y la sostenibilidad.

Cultura y Agenda 2030
En septiembre de 2015, cuando se aprobó la Agenda 2030, también se fijaron los Objetivos de Desarrollo Sostenible. La introducción de la cultura en los ODS supone ciudades más seguras y sostenibles, crecimiento económico y detención de la degradación del medio ambiente; tres pilares básicos de desarrollo sostenible.

Así es como, jugaría un papel transversal, fomentando sociedades más justas y democráticas. Marta Haro, directora de la red española sostenible afirma que: “Sin desarrollo sostenible, no hay futuro”. "
17/12/2019,News,38,50,3,3,94,La esperanza viene del pueblo según Greta Thunberg,"500.000 personas se manifestaron el pasado 6 de diciembre en las calles del centro de Madrid reclamando una solución al cambio climático.

La manifestación comenzó a las 18hs en la puerta del museo del Prado en dirección a Nuevos Ministerios, donde esperaba un gran escenario bajo la consigna “Emergencia climática”.

“La esperanza no está dentro de los muros de la COP25, la esperanza está aquí contigo” delcaró Greta Thunberg. La activista sueca afirmó que “tenemos que prestar nuestra voz a la gente del Sur Global y a los pueblos indígenas, que son los que más sufren por la emergencia climática y ambiental”.


Los hermanos “kletterkinder”, de 8 y 11 años, también se hicieron presentes en la manifestación. Generaron polémica al colgarse de un puente que cruzaba la manifestación con un cartel con el lema “Solo 8 años hasta 1.5ºC. ¿CÓMO SE ATREVEN?”.

“Justicia climática ya!”, “El cuidado de la tierra no es un lujo, sino una supervivencia”, “El planeta por encima del lucro”, “Negarlo es suicidio” y “No mates mi futuro” eran los lemas más leídos. Las pancartas referidas a las problemáticas de los pueblos originarios y del conflicto chileno, también tuvieron lugar: “Defendamos la Pachamama”, “Sangre indígena: ni una gota más”, “No más represión al pueblo mapuche”, “El modelo neoliberal nace y muere en Chile”. Con claro tinte internacional, muchas de ellas estaban escritas en inglés."
30/09/2021,News,816,179,91,0,1086,La lava llega al mar,"Finalmente, la lava del volcán de la Palma llega al mar. Esto sucedió el pasado martes por la noche, lo cual está creando una densa nube de vapor de agua y otros gases. ¿Se puede considerar peligrosa? No, por el momento no provocaría ningún riesgo para la salud. 
Desde que erupcionó por primera vez el volcán, el domingo 19 de septiembre, no ha dejado de expulsar grandes cantidades de lava y ceniza, destrozando más de 400 casas, además de cultivos. Uno de los interrogantes que han surgido a lo largo de estos días es qué ocurriría si la lava llegara al mar y tiene contacto con el agua.
Joan Martín, vulcanólogo del CSIC, le declaró a EFEverde que: “la cantidad de gases que desprende la lava al entrar en contacto con el agua del mar es pequeña y se dispersará de forma rápida, por lo que la afección será local y no habrá problemas si se siguen las recomendaciones de las autoridades.” De tal forma, se espera que no ocasione grandes riesgos para la salud de los habitantes del lugar.
Se ha originado un delta de lava con la llegada de la lava al mar
Una vez que la lava toca el agua, se empieza a solidificar y se va acumulando en la desembocadura de la colada, creando así un delta de lava. Los científicos del Instituto Español de Oceanografía aseguran que el material magmático que cayó en el océano, el pasado martes, ha formado una especie de pirámide de más de 50 metros.
Ahora el riesgo está en si se colapsa o no esta formación. Estos colapsos pueden generar explosiones violentas y consecuencias impredecibles. Un ejemplo es el colapso del delta de lava en Hawaii en 1993, el cual produjo una lluvia de rocas ardiendo que provocó la muerte de varias personas. 
Por su parte, Ángel Victor Torres, presidente de las Islas Canarias, ha dicho en una entrevista radiofónica que espera que la colada de lava deje de ensancharse, ya que la apertura del canal creado por la lava está arrasando con viviendas y explotaciones agrícolas.
Se recomienda que los vecinos cercanos al volcán de La Palma se confinen en sus hogares
Desde el gobierno y también los expertos piden que se tomen todas las medidas de precaución. Cerrar las puertas y ventanas de las casas para que no entren gases de fuera. También se prohíbe el acceso a las zonas evacuadas. El lado “positivo” de que la lava haya llegado al mar es que permitirá que el flujo de la misma corra de manera más continua, evitando que se ensanche y termine provocando más daños en la isla.
En conclusión, habrá que ver como evoluciona los próximos días la colada de lava para saber si se colapsará o no el delta de lava."
4/03/2020,News,94,33,3,0,130,La mitad de las playas del mundo desaparecerán si no se reducen las emisiones de gases de efecto invernadero,"Los nuevos patrones de lluvias que se han instalado recientemente en Europa despiertan aún más preocupaciones entre los expertos en cambio climático.
La Agencia Europea de Medio Ambiente tiene ahora por objetivo devolver a los ríos sus zonas inundables. 

A su vez, el Grupo Intergubernamental de Expertos sobre Cambio Climático, advertía la semana pasada sobre un incremento del nivel del mar de 1 metro. Su último informe analiza los efectos del cambio climático en los océanos y en la criosfera y declara la preocupación por que desaparezcan el 80% de los glaciares y se vean afectadas 1.350 millones de personas si no se actúa rápidamente.

La consecuencia de este descongelamiento no es únicamente la pérdida de los glaciares, si no también el aumento del nivel del mar. Según los científicos, ha estado en constante aumento desde el siglo XX, pero en los últimos años ha incrementado al doble de lo que se estimaba crecía por año (8.6cm). 

Un reciente estudio expone que para el 2100, alrededor de un 40% de las costas podría perderse. Esto implica, por ejemplo, que España pierda muchas de sus playas a finales de siglo. 
Las playas de arena ocupan el 30% de la costa de todo el mundo y estas zonas albergan al 44% de la población mundial, por lo que la desaparición, pondría en peligro actividades económicas de las que se sirven muchos. 

“Las playas tienen un valor ecológico incalculable ya que acogen especies que no pueden vivir en otros ambientes. Al estar en primera línea de mar también suponen una protección frente a inundaciones, tormentas marinas y ciclones”, comenta a SINC Michalis Vousdoukas, miembro del Joint Research Centre de la Comisión Europea en Ispra y autor de este estudio.

Los investigadores concluyeron que “las playas seguirán erosionándose y algunas desaparecerán”. En Asia occidental y oriental y en los pequeños países insulares del Caribe, se espera una retirada de la costa de hasta 300 metros a largo plazo.

La República Democrática del Congo, Gambia, Jersey, Surinam, Comoras, Palau, Benin, Guinea-Bissau, Mayotte (Francia), Iraq, Pakistán, Guinea y El Salvador podrían perder hasta el 80 % de su costa arenosa. Australia, que posee 12.324 de costa, será el país que más perderá."
21/05/2021,News,641,158,56,3,858,Las futuras pandemias se podrían evitar según los expertos,"La comunidad científica, sigue buscando la manera de que virus ya existentes no lleguen a convertirse en futuras pandemias. Tanto la última hoja de ruta de la OMS, como el informe del IPBES, son prueba de ello. Exploran cómo pasar de la reacción a la prevención.

El informe del IPBES , organización Intergubernamental Científica que establece normas sobre Diversidad y Ecosistemas, declara que las pandemias en el futuro surgirán con más frecuencia. Hasta podrían tener un mayor impacto en la economía mundial que el COVID-19. Aún así, los expertos coinciden en que escapar de la era de las pandemias es posible.

Por otro lado, la hoja de ruta de la OMS, busca reducir un 90% las Enfermedades tropicales Desatendidas para 2021-2030. Estas están afectando a la población más pobre del planeta. Y la solución que recomiendan para conseguirlo es el acceso al agua potable, el saneamiento y la higiene.

La constante persecución de una solución resulta muy alentadora, pero ¿Se destinará el presupuesto necesario para lograrlo?  “Post pandemia los presupuestos de los países desarrollados o primermundistas van a estar enfocados en su reconstrucción. Es muy probable que  este tipo de temática quede totalmente en un segundo plano. Si creo que agua potable, saneamiento e higiene son la solución, pero ese capital no creo que esté destinado a países en vías de desarrollo con estos problemas ” comentó la Dra. Marianne Bizzozzero a Econews Today. 

Entender el origen de las futuras pandemias es la clave para poder prevenirlas
Hay demasiadas personas en el mundo, con formas y costumbres dañinas. “No hay un gran misterio sobre la causa de la pandemia de COVID-19 —o de cualquier pandemia moderna—. Las mismas actividades humanas que impulsan el cambio climático y la pérdida de biodiversidad también generan riesgos de pandemia a través de sus impactos en nuestro medio ambiente”, expresó el Dr. Peter Daszak, presidente de EcoHealth Alliance, en el taller de la IPBES. 

Al comparar la evolución de otras pandemias como la MERS en 2003, la Gripe Aviar en 2009 y el Coronavirus hoy, queda al descubierto que la aparición de futuras pandemias es una posibilidad. Según la Dra. Bizzozzero, para evitar o disminuir la aparición de las mismas, se debería por lo menos cambiar el estilo de vida alimenticio de gran parte de la población mundial. 

Actualmente hay enfermedades con una gran letalidad, como el ébola o el VIH. Pero al ser su contagio por fluidos, prevenirlas es más fácil. Al contrario, las enfermedades respiratorias resultan altamente contagiosas. Como es el caso del Covid-19. Se transmite por aire, y todos los seres humanos lo respiran. Entonces, es posible que las futuras pandemias accionen de una manera similar a esta. 

Los expertos proponen una serie de opciones para hacer frente a la posibilidad de futuras pandemias, como cambiar los hábitos de consumo, o poner impuestos en la compra de carne.

A su vez, la OMS da un llamado de atención a los Estados miembros, donantes, expertos en enfermedades. Para que fusionen sus estrategias y planes hacia la prevención de infecciones. Y muy importante, poder aliviar el sufrimiento de las personas afectadas."
26/05/2020,News,70,23,3,12,108,Las nuevas formas de transporte brindan beneficios medioambientales,"Sin dudas el brote de coronavirus está cambiando la vida de cada uno de nosotros. Nuestros hábitos y conductas se están viendo alterados, muchas veces a nuestro pesar. “En el momento en que empiece a tener que ir al trabajo, iré caminando. Me parece mucho mejor que estar subiéndose a un transporte”, dice Luisina Otero, contadora pública de 25 años. Como millones de argentinos, solía utilizar el transporte para ir a su trabajo en el microcentro de la ciudad de Buenos Aires, Argentina. 

Son muchos los que se encuentran sacando las mismas conclusiones. Tomará tiempo recuperar la confianza.

Los gobiernos de todo el mundo se enfrentan a la tarea de adaptarse a las circunstancias actuales y reestructurar las normas de circulación. El distanciamiento social es la prioridad, pero se advierte también sobre lo trascendental que estas medidas resultan para el medio ambiente.

De acuerdo con datos del Banco Interamericano del Desarrollo, en importantes centros urbanos de América Latina como Ciudad de México, Río de Janeiro o Medellín, los niveles de concentración de NO2 (Dióxido de Nitrógeno), a la semana del 26 de abril al 5 de mayo, disminuyeron entre el 35% y el 83%.

El viernes 15 de mayo Londres anunció un proyecto que cierra muchas de sus principales calles y avenidas para el tránsito de automóviles, y quedarán sólo habilitadas para colectivos, ciclistas y personas caminando.

Lo mismo se busca hacer en Buenos Aires donde más de 100 calles se están transformando en peatonales.

Ahora más que nunca, a pedalear
Más bicicleta. Menos transporte público. A eso apuntan las nuevas medidas de intervención urbana en todas partes del mundo, que coinciden en que el distanciamiento social en subtes y colectivos es prácticamente imposible.

En Francia un plan de 20 millones de euros busca ofrecer capacitaciones para el uso de bicicletas, estacionamientos temporales para las mismas y además proporcionará a las personas paquetes de 50 euros en caso de necesitar hacer alguna reparación.

En varios países, la propia ciudadanía comenzó a optar por la bicicleta antes de la toma de medidas concretas por parte del gobierno. Este es el caso de varias ciudades en los Estados Unidos, cuyos negocios de bicicletas registraron un aumento en sus ventas como no se había visto en mucho tiempo."
12/07/2021,News,367,70,47,3,487,Las pitones birmanas devoran Florida,"El estado de Florida se enfrenta a su peor invasión: Las pitones birmanas. Este peligroso reptil está devorando el estado de Florida. El canal norteamericano de televisión AméricaTeVé ha hecho llegar esta problemática a sus ciudadanos a través de la serie documental “SOS Invasoras en el pantano’’. Hablamos con Irene Díaz, periodista y directora de este proyecto audiovisual.

1. Explícanos en qué se basa la serie-documental “SOS INVASORAS EN EL PANTANO’’.
La serie se basa en el problema medioambiental que sufren Los Everglades, uno de los ecosistemas más valiosos del planeta, debido a la plaga de pitones birmanas.

Los Everglades fueron declarados Reserva Internacional de la Biosfera en 1976 y Patrimonio de la Humanidad en 1979. Este enorme humedal a pocos kilómetros de Miami tiene una increíble variedad de vida salvaje con cientos de especies que conviven en tierra, mar y aire. Pero esta vida salvaje está amenazada por la sobrepoblación de pitones birmanas.

La serie aborda el contexto, la problemática y las soluciones de caza que se practican en la actualidad. Trata de dar voz a la mayor cantidad de personas y entidades implicadas para que la población tome conciencia y saque sus propias conclusiones. 

2. ¿Cuál fue tu motivación para ponerte al frente de este proyecto?
Fue una motivación doble. La primera es el amor que le tengo a los animales y a los Everglades, y la segunda es la confrontación de un miedo, ya que las serpientes me asustaban bastante, así que quise enfrentarlo para superarlo.

La idea surgió después de ver un banner en Internet que anunciaba la celebración de un concurso de cazar pitones. Una idea muy loca que me llamó la atención pero que en un primer momento descarté por mi miedo a las serpientes. Pero el banner seguía apareciendo y empecé a leer sobre eso y a descubrir la problemática real tras esos concursos… y me interesó tanto que me lancé a la piscina.

3. Te desplazaste al lugar afectado y esta serie documental tardó en grabarse año y medio. ¿Hubo alguna situación inesperada o que te marcara especialmente durante el proceso de grabación del proyecto?
Viví muchas situaciones complejas, la primera fue acercarme a las serpientes. En los primeros días de rodaje daba las indicaciones al cámara a distancia, pero luego con el paso de las semanas fui cogiendo confianza hasta poder acercarme por completo, incluso llegué a tocarlas mientras las sostenían. Allí pasaba un poco de angustia, lo peor era caminar con los pies hundidos sin saber dónde pisabas. En esos momentos te sientes muy vulnerable. 

4. Para ver la peligrosidad que tiene esta especie de pitón y natural de regiones como: Nepal, India o China, habéis hablado con expertos que explican cómo ha acabado con especies autóctonas del lugar. ¿Qué otros daños está dejando esta especie de pitón en el estado de Florida?
Para realizar la serie fueron entrevistados varios expertos en animales y en la problemática exacta de ese lugar. Éstos señalaron que se ha dado un explosivo crecimiento poblacional de pitones birmanas en los Everglades y están arrasando con la vida silvestre del lugar. No existe evidencia que las pitones Birmanas cacen humanos pero hay casos en que grandes pitones Birmanas en cautiverio han matado a sus dueños. 

5. Debido al gran número de pitones que se registra en el territorio de Los Everglades, ¿Florida podría registrar apariciones en zonas habitadas?
Sí, debido a su habilidad para desplazarse largas distancias. En Florida han sido vistas en casas, en coches y en carreteras, lo que representa un peligro para los que van en moto o bicicleta.

6.La emisión de esta serie documental se podrá ver los días 21, 22 y 23 de Junio a través del noticiero AN7 del canal America Tevé. ¿Pero dónde más lo podremos encontrar? ¿Y por qué los lectores de Econews Today no se lo pueden perder?
Sí, la serie fue emitida en el noticiero de America Tevé los días 21, 22 y 23 de Junio. Ahora la han colgado en Youtube. Es una serie rápida y amena. Y permite obtener una radiografía del problema. La serie no da la solución definitiva y tampoco se posiciona, sólo es un altavoz para que el asunto llegue a los ciudadanos. Además, me he centrado en un enfoque personal para hacerla más cercana."
28/09/2021,News,449,118,33,12,612,Las playas del litoral catalán pierden terreno,"Las playas del Maresme, el litoral catalán, pierden terreno debido a los fenómenos
torrenciales de los últimos tiempos. Este hecho ha imposibilitado que las playas
se recuperen de manera natural de lluvias torrenciales. Ya acumulan
una regresión de entre seis y diez metros de amplitud anuales, según un reciente
estudio del Área Metropolitana de Barcelona (AMB).

Las playas más afectadas por esta regresión del terreno son las de los municipios
de Badalona y Montgat. Para frenar la problemática los ayuntamientos de cada localidad han propuesto la construcción de espigones de larga distancia y así, podrán frenar esta pérdida de terreno año tras año.

La solución a la pérdida de terreno del litoral catalán pasa por añadir espigones e introducir arena
Según informa el medio local TOT BADALONA, para una recuperación completa de
estas playas sería necesario implantar cinco espigones de 250 metros sumergidos
en el mar e introducir 600.000 m3 de arena en Montgat y, en Badalona, introducir 102.000 m3 de arena y construir un espigón de apoyo.

Aunque la problemática de la regresión en las costas ha cobrado fuerza en estos
últimos cuatro años, el gobierno central ya trabajaba sobre el problema desde 2015 con el plan Estrategia de actuación del Maresme. Este plan cuenta con la construcción de una treintena de espigones desde Montgat a Malgrat de Mar y el desplazamiento de 5 millones de metros cúbicos de arena para retroalimentar terrenos afectados.

Se deben reubicar las zonas industriales que están actualmente en zonas de costa, a lo que muchos municipios se han opuesto. Según informa Ramón Torra, gerente de AMB en declaraciones al diario La Vanguardia, esta problemática viene dándose por el cambio climático, pero también por la sobreexplotación de terrenos para la construcción de edificaciones a pie de costa.Urbanización costera: un problema en auge
Según informa la investigadora Carla García, las playas son sistemas dinámicos y
con una gran capacidad de recuperación, pero debido a la construcción de nuevas
infraestructuras urbanísticas, esto no se puede dar. Estas zonas están sometidas a rígidos sistemas de ingeniería, que alteran el ciclo natural de las costas y provocan la pérdida de biodiversidad en las playas.

Se estima que algunas playas del litoral catalán han perdido ya hasta un 50% de su
terreno inicial. En muchas de ellas también se ha registrado un considerable crecimiento
del nivel del mar.

Se aboga por hacer un uso responsable de los espacios costeros. La falta de legislación política sobre el uso de terrenos costeros, pone de manifiesto los reservorios de dunas, un elemento básico para el correcto funcionamiento de las playas."
31/03/2020,News,70,12,3,0,85,Líderes de la UE prometen considerar el clima en los planes de recuperación,"Las fuertes y aceleradas inversiones en las economías como respuesta a la crisis económica del coronavirus, es el mayor temor de los grupos ambientalistas. 

Con apenas un par de meses de confinamiento, cierre de fábricas y bloqueo de actividades, los niveles de contaminación atmosférica han reducido notablemente. Pero es sabido que esto es puramente temporal. Lo que sucederá después de la crisis, cuando todo regrese a la “normalidad” depende de las medidas que tomen los estados de cara a la recuperación económica. 

Tras los reclamos de los expertos sobre los temores de que los planes de rescate económicos sean tomados de forma acelerada, los líderes de la Unión Europea acordaron prestar atención al objetivo de combatir el cambio climático. Muchos políticos, economistas y activistas dicen que las medidas deberían usarse para acelerar el cambio del carbón, el petróleo y el gas que calientan el planeta.

Una coalición global de más de 300 grupos de campaña de cambio climático instó a los gobiernos el jueves a usar cualquier paquete de rescate económico de coronavirus para ayudar a acelerar la transición hacia un futuro bajo en carbono.

Acordaron una “transición verde”, esa es la frase que utilizan para describir el objetivo de reducir las emisiones. Los detalles del plan quedan aún pendientes. 

La comisión ejecutiva de la UE llama a sus miembros a celebrar una cumbre en junio para planificar la neutralización de todo el bloque de gases de efecto invernadero. El detalle se halla en la fecha estimada: 2050. 

Los planes en diferentes países
Los inversores y los grupos ambientalistas buscan garantías de que, a medida que las consecuencias económicas del coronavirus absorben fondos y energía política, Bruselas no perderá de vista sus objetivos de cambio climático.

Polonia ha advertido que la pandemia hará que los objetivos climáticos de la UE sean más difíciles de alcanzar.

«Las decisiones que se toman en este momento darán forma a nuestra sociedad durante años, si no en las próximas décadas», dijo en un comunicado May Boeve, director ejecutivo de 350.org, un grupo de campaña climática global que se originó en los campus universitarios de EE. UU."
11/05/2021,News,731,182,64,15,992,Llega a Barcelona el primer sistema de recogida de residuos puerta a puerta de bolsas con chip,"Barcelona instaura nuevos sistemas de recogida de basuras en algunos de sus barrios. El próximo 24 de Mayo, el barrio de Sant Andreu del Palomar pasará a tener menos contenedores y la recogida de sus residuos será de puerta a puerta, mediante un sistema de bolsas con chip.

Alrededor de 20.000 ciudadanos pondrán en práctica este nuevo método de separación de residuos en sus domicilios. Esta norma se aplicará también a los comercios del barrio. De momento, sólo se ha aplicado en dos barrios catalanes, pero se espera que para 2025 este nuevo sistema de reciclaje se haya extendido por todo el territorio catalán. 

En Barcelona sólo recicla alrededor del 38% de sus habitantes, según informa el Ayuntamiento; y se genera una cantidad cercana a los 500 kilos de residuos al año. Este nuevo modelo ayudará a saber qué domicilios reciclan con frecuencia y tendrá una finalidad totalmente educativa. Así lo aclara Eloi Badia, Concejal de Emergencia Climática. 

Con la implantación de nuevos sistemas de recogida, se quiere acabar también con recurrentes problemáticas a las que se enfrentan algunos ayuntamientos, como la recogida de pañales. En el barrio de Sarriá ya se instauró este sistema con anterioridad y se han registrado resultados datos muy positivos.

España a la cola de Europa en políticas de reciclaje
En los últimos años España ha registrado una tendencia a la baja en sus datos de gestión de residuos y compromiso medioambiental.

Una ley aprobada en 2011 conjuntamente con instituciones europeas, obligaba a España a reciclar un 50% de sus residuos. De los cuales, apenas, se recicla un 35%.
Las autoridades ya han sido advertidas sobre su mala gestión en materia de residuos urbanos. Incluso España ha sido denunciada ante la Comisión Europea por diferentes asociaciones ecologistas por el mismo motivo. 

“España incumplió el objetivo europeo de reciclar el 50% de los residuos domésticos en 2020’’- según informa el diario La Vanguardia.

Sólo dos comunidades autónomas cumplen con los datos establecidos por la normativa: Cataluña y Euskadi. Pero aún y así, España, está muy lejos de conseguir el objetivo que se fijó en 2011 con la aprobación de la Ley de residuos. Esta problemática, se debe a una escasa legislación en las tasas de desecho y una falta de compromiso medioambiental.

Ante estos datos demoledores para España, respecto a países vecinos, el Gobierno ya trabaja en un anteproyecto de Ley de residuos. Así como, en la creación del “Impuesto verde’’. Un impuesto de 0,45 céntimos aplicados a envases de plástico de un solo uso por cada kilo de ellos consumido. De esta manera, quieren impulsar una conciencia de reciclaje y cuidado por el medioambiente entre sus ciudadanos. "
16/08/2021,News,161,29,53,3,246,Los incendios arrasan en el mediterráneo,"Durante los meses de verano, las olas de calor son moneda corriente. Según la Agencia Estatal de Meteorología (AEMET), se trata de episodios de temperaturas anormalmente altas que se mantienen varios días y afectan a una gran parte de la geografía. Muchas veces son la causa de los incendios.

En las últimas semanas, una ola de calor ha arrasado en varios países del mediterráneo. Las altas temperaturas alcanzadas son la clara evidencia de una crisis climática latente. 

El cambio climático está influyendo en la frecuencia, la duración y la intensidad de los incendios.

Según investigadores del IPCC, el clima global está cambiando rápidamente, y las temperaturas del planeta se están incrementando como no lo han hecho en los últimos 2000 años.

Turquía está viviendo una de sus peores oleadas de incendios con 200 focos y ya 200.000 hectáreas quemadas. Además de 8 víctimas mortales y 400 heridos. Grecia tuvo más de 80 focos en un día y se han consumido cerca de 100.000 hectáreas. “Lo de Grecia y Turquía es una nueva normalidad que vamos a ver con el cambio climático” -aseguró Juan González, especialista en cambio climático de la Complutense a El País. 

Falta un informe específico que demuestre que estos incendios se producen puramente a causa del calentamiento global
Hasta el momento no existe un estudio en concreto sobre estos fuegos. Es por eso que no se lo puede relacionar de forma categórica con el cambio climático, explican en El País. Lo que sí puede considerarse un indicador del calentamiento global son los registros excepcionales de temperaturas. Grecia ha llegado a 47º, su pico más alto de los últimos 40 años. 

Los estudios de atribución resultan costosos, por lo tanto, es difícil poder demostrar científicamente la unión entre un evento meteorológico extremo y el calentamiento climático, según dice Gonzalez.

¿Por qué es importante un estudio de atribución de eventos extremos? Para saber si el calentamiento global influye en la intensidad de un evento climático extremo. Esto puede ayudar a las personas en comunidades afectadas a desarrollar planes de recuperación para un futuro riesgo, explican de Climate.gov. 

Adaptarse a la nueva normalidad requerirá medios propios y ayuda externa
Se necesita colaboración para ponerle un freno a los incendios, no solo económico, también refuerzos como bomberos, helicópteros, etc. En el caso de Grecia, el comisario europeo de Gestión de Crisis escribió en Twitter que: “La UE está enviando capacidades de extinción de incendios adicionales a Grecia y Macedonia del Norte para apoyar la respuesta local”.

Entonces, ¿Por qué los países que suelen arder en verano necesitan de tanto apoyo externo? Es necesario hacer inversiones, por un lado un estudio para poder detectar de raíz dónde y cómo surge el problema. Además, lograr tener los medios propios para enfrentarse a los fuegos, sin depender total y exclusivamente de ayuda extranjera."
21/04/2020,News,70,9,3,9,91,Medusas en las aguas limpias de Venecia,"Desde que comenzó el confinamiento en distintas partes del mundo, los animales han ido apareciendo en sitios donde ya habíamos perdido esperanzas de volver a verlos.

La marea baja y el poco tráfico de góndolas y barcos ha aumentado la transparencia del agua y han permitido observar la vida marina directamente en el centro de Venecia (Italia), un efecto secundario positivo inesperado de la pandemia de coronavirus, que se suma a la reducción de CO2.

Attilio Rinaldi, profesor adjunto del Departamento de Ciencias Biológicas, Geológicas y Ambientales de la Universidad de Bolonia, explica que la especie de medusa observada es muy común en el Adriático superior y podría ingresar a los canales venecianos a través de flujos de marea que conectan este mar con la laguna.

A esta lista se suman delfines en Badalona (España), los ciervos de Nara en Japón y esperamos que más animales se continúen sumando. De la misma manera, que cuando todo regrese a la nueva normalidad, se tomen las políticas ambientales necesarias para proteger a estas especies."
22/04/2021,News,354,82,41,12,489,Por una nueva relación con la naturaleza,"Restaurar nuestra tierra es el tema que la Organización de Naciones Unidas eligió como eje para este 22 de abril en el Día Internacional de la Madre Tierra 2021.
Según el diccionario de la Real Academia Española, restaurar significa “recuperar o recobrar”. También significa “reparar, renovar o volver a poner algo en el estado o estimación que antes tenía”. Es por ello que no sorprenden las palabras del Secretario General de las Naciones Unidas, António Guterres quien afirmó que “ha llegado el momento de que nos replanteemos nuestra relación con la naturaleza y empecemos de cero”.

La crisis ambiental impone la necesidad de pensar acciones para recuperar nuestra tierra. El cambio climático, los incendios forestales, la degradación de los ecosistemas, el uso de plástico, la deforestación y la pandemia de Covid-19 ponen a la humanidad frente a una urgencia que resulta imposible de evadir: nuestro bienestar y el de la naturaleza no van por caminos separados.

Es en este sentido que el 21 de junio de 2021 la ONU dará comienzo al Decenio de las Naciones Unidas sobre la Restauración de los Ecosistemas. Este proyecto busca “prevenir, detener y revertir la degradación de los ecosistemas en todos los continentes y océanos; así, se puede ayudar a erradicar la pobreza, combatir el cambio climático y prevenir una extinción masiva”. Esta iniciativa será lanzada el 5 de junio, Día Mundial del Medio Ambiente.

Resulta necesario que el desarrollo sostenible y la protección del ambiente ocupen un lugar cada vez más preponderante en las políticas gubernamentales tal como lo propone la Agenda 2030 de la ONU. Recuperar los ecosistemas es una misión mundial. Repensar el vínculo con la naturaleza se convierte en un asunto necesario sólo de ese modo se avanzará en pos de restaurar nuestra tierra."
6/04/2020,News,144,62,3,3,212,"Qué es un virus, cómo lo enfrentamos y porqué lo hacemos con jabón","En medio de la incertidumbre, intentamos buscar respuestas, despejar las dudas, sembrar un poco de claridad para entender a qué nos estamos enfrentando y cómo lo estamos haciendo. 

Aún no se conoce con seguridad qué animal originó el brote de SARS-CoV-2, pero todo apunta a que sucedió en China. Intentaremos entender de manera más simple y dejando a un lado los tecnicismos qué es un virus, a qué nos enfrentamos y por qué lo hacemos con jabón. 

Partículas, moléculas y microorganismos rigen en muchas maneras nuestra vida. La micro biología es la ciencia que se dedica a estudiar a todos los seres vivos y agentes infecciosos invisibles al ojo humano. 

Estos resultan ser de suma importancia ya que representan la mayor parte de biomasa del planeta. Además, no solo tienen alta relevancia en el área de la salud y los alimentos sino también en la generación de combustibles. De alguna manera pueden estar de nuestro lado, ayudándonos, o en nuestra contra presentándose como una amenaza.

¿Qué es un virus?

Un virus no es ni más ni menos que una porción de material genético sin vida. Éste esta contenido en una cápsula formada por proteínas y grasas. 

El virus no puede reproducirse por sí mismo; por ende utiliza al huésped infectado para hacerlo. Así, inyecta su contenido genético en las células del huesped para fabricar las que requiera él. En otras palabras, nos enferma ya que estamos utilizando información defectuosa para desarrollarnos.

¿Cuál es la diferencia entre una bacteria y un virus?

La bacteria es un microorganismo vivo. Crece por sí misma y puede habitar tanto en alimentos como en distintos medios. Ésta no necesita de un huésped para reproducirse. Se replica en determinadas condiciones de ph , humedad y temperatura. 

 Entonces, ¿Cuál es más peligroso?

Dependiendo de diversos factores, hay bacterias letales como los hay virus. Pero se ha demostrado que por su alto nivel de contagio y por ser difíciles de controlar se podría decir que los virus son más peligrosos. Esto tiene mucho que ver con que la bacteria es un microorganismo vivo y el virus no lo es. Por lo tanto es difícil matar algo que no esta vivo. 

¿Y el Covid 19?

El Covid 19, en sí no es un virus agresivo, como sí lo es el VIH. Lo desafiante esta situación es el mediano control que tenemos sobre esta enfermedad producida por el virus. 

Al ser imposible matar un virus, debemos buscar maneras de hacerle frente y esto se hace desactivándolo. Como tiene una estructura compuesta por proteínas y lípidos, para desactivarlo debemos utilizar agua y jabón, alcohol o lavandina, ya que desarman sus componentes estructurales. 

¿Qué se espera de momento?

En una instancia final lo que mejor puede atacar a un virus es el sistema inmunitario, ya que es quien termina enfrentándose al mismo y quién genera una inmunidad, por los anticuerpos ganados durante esta batalla."
4/05/2020,News,102,18,3,9,132,Residuos: La consecuencia no tan visible de la pandemia,"Hay una gran preocupación por parte de los ambientalistas respecto a la inmensa cantidad de residuos generados como consecuencia de esta pandemia. Está claro que el impacto ambiental de estos residuos es difícil de reducir, ya que las mascarillas pueden estar contaminadas con el virus y por ende, se hace indispensable desecharlas en un punto.

La UNE, ha desarrollado un documento en el que especifica todo lo relativo al proceso de fabricación de las mascarillas descartables y reutilizables. Además, declara el objetivo de proteger a las personas y al medio ambiente. 

Las mascarillas descartables, se desechan en el contenedor gris o aquel denominado “para restos”. Los residuos en este caso no son reciclados ni utilizados para hacer compost. 

En líneas generales, las mascarillas deben cumpir con ciertos requisitos de materiales, diseño, confección, marcado y uso. Utilizar una mascarilla que no cumple con lo detallado por esta entidad puede resultar perjudicial para la salud. 

Estos requisitos son: 

Cubrir nariz, boca y barbilla.
Estar confeccionadas con un material reutilizable filtrante adecuado.
Estar confeccionadas con material reutilizable que permita la respiración.
Utilizar materiales reutilizables que en contacto con la piel no presenten riesgos conocidos de irritación o efectos adversos para la salud. 
Garantizar un ajuste adecuado con la cara.
Contaminación marina
Nuevamente, el pulmón del planeta se ve amenazado. La organización activista Oceans Asia publicó recientemente un artículo en el que explica la preocupación de las mascaras quirúrgicas en las playas. En esta oportunidad, estos residuos han terminado en pequeñas islas deshabitadas del archipiélago de Soko. 

Stokes, fundador de la organización cuenta en este vídeo cómo ha ido incrementando la cantidad de este tipo de residuos en las últimas semanas. 


¿Qué alternativa tenemos? Apostar por las mascarillas reutilizables, con el fin de que nuestro impacto en el medio ambiente sea lo menor posible. "
26/08/2021,News,754,108,49,12,923,Riesgo Climático de la Infancia: niños expuestos al Cambio Climático,"1.000 millones de niños viven expuestos a las consecuencias de la Crisis Climática, según el Índice de Riesgo Climático de la Infancia de UNICEF. Exactamente representan casi la mitad de todos los niños y niñas que habitan hoy en nuestro planeta. ¿Por qué son considerados los más afectados? Son más vulnerables a las condiciones meteorológicas extremas y deberán vivir en un mundo que se vuelve cada vez más peligroso. 

El cambio climático nos afecta a todos, da igual tu raza, religión, orientación sexual o estatus social. Nadie queda exento. Pero, hay quienes podrían verse más expuestos: los niños. Principalmente si en el país donde viven no se dan las condiciones básicas de saneamiento y no tienen acceso a agua potable. 

En la medida que se siga calentando el planeta tierra, las catástrofes naturales, las sequías y los incendios seguirán aumentando en número e intensidad. El cambio climático es la mayor amenaza a la que se enfrentan los niños y los jóvenes del mundo, aseguran en UNICEF. Es el caso del joven activista climático, Nkosilathi Nyathi en de Zimbabwe. Vive con la incertidumbre de si podrá o no ir a la escuela debido al “sol abrasador”. Este no es un punto aislado, es la cotidianidad de millones de jóvenes que viven en continua vulnerabilidad. 

Los países que más riesgo climático de la infancia tienen son los que menos huella de carbono dejan
Según el Índice, los niños de la República Centroafricana, el Chad, Nigeria, Guinea y Guinea-Bissau son los más expuestos. Estos países emiten tan solo el 9% de las emisiones de CO2 en todo el mundo. Al contrario, los países que más emiten representan en total cerca del 70% de las emisiones mundiales. Entre estos, solo uno es de riesgo extremadamente alto. ¿Injusticia? Unicef  dice que: “Es inmoral que los países menos culpables sean las primeras víctimas y las que más sufren”.

Es un llamado de atención tanto al sector empresarial como a los gobiernos del mundo que escuchen a los niños y que se dé prioridad a las medidas que los protegen de los efectos del cambio climático. 

España en la zona media- baja ocupando el puesto 124
Un punto positivo del ranking es que España se encuentra en la zona “media-baja” de entre un total de 200 países.  «Hay que reducir las emisiones que genera el efecto invernadero, hay que trabajar para mitigar y para generar sistemas que ayuden a los niños y niñas a reducir el impacto de la crisis climática donde ya está afectando”, advierte Blanca Carazo, responsable de los Programas de UNICEF España. Se quiere que los niños y jóvenes puedan participar en todas las decisiones que tengan que ver con la Crisis Climática."
4/05/2021,News,620,263,55,15,953,Save Ralph: ¿Llamado de atención a las industrias o al consumidor?,"Las últimas semanas se viralizó en muchos lugares del mundo el corto animado de Save Ralph sobre el testeo en animales. Éste relata la vida de un conejo de testeo, tras años de ser usado por los humanos en experimentos de grandes empresas de belleza.

No es novedad que a nivel mundial la industria de la belleza, la higiene y la farmacéutica realizan pruebas con animales para llevar a cabo sus productos. Si bien el movimiento cruelty free está cada vez más en auge, aún así las pruebas con animales son legales en muchos países del mundo.

La Directiva 2010/63, de la Unión Europea, no solo protege a los animales utilizados en la ciencia, sino que también proporciona una estrategia para reemplazar la experimentación con animales. Esta reglamentación entró en vigor el 9 de noviembre de 2010 y debía aplicarse en los países de la UE a partir del 1 de enero de 2013.

¿Cuál es el fin del cortometraje?

Con esta campaña la ONG Humane Society International buscó generar conciencia sobre la persistencia de las prácticas sobre animales. Para conseguirlo convocaron a famosos como Ricky Gervais y Zac Efron, para darle voz a los personajes del corto. Con este contundente mensaje piden prohibir las pruebas con animales para cosméticos. También, visibilizar el sufrimiento de las criaturas ante los ensayos de las industrias de belleza e higiene personal.

Está claro que el aviso busca un impacto sobre la imagen de las empresas que hacen pruebas con animales. Pero, ¿Qué hay del consumidor? A una persona empática, le resultará muy fácil sensibilizarse con el corto; ya sea por sus animaciones, sus voces o su guion.

La pregunta es si quienes consumen estos productos lo dejarán de hacer, o al cabo de unas semanas la campaña quedará en el olvido.

Y en España, ¿también sucede?

A principio de abril, de este mismo año, salieron a la luz varias imágenes perturbadoras del laboratorio de Vivotecnia, en Madrid. La organización está dedicada a la investigación por contrato para farmacéuticas y biotecnológicas. Las imágenes muestran la extrema crueldad en el testeo en animales que realiza la empresa alemana a distintas especies.

Según El País, las imágenes que dio a conocer Cruelty Free International fueron grabadas por una extrabajadora de la empresa cuya identidad se mantiene en el anonimato. La denunciante afirmó que había hablado con sus superiores pero no obtuvo respuesta. El abogado de la organización y quien la representa actualmente, Carlos Contreras, dice que la aplicación de técnicas que causan dolor y sufrimiento hacia los animales son innecesarias. 

Al publicarse el video de Vivotecnia, la Asociación Europea de Investigación Animal (EARA), emitió un comunicado en respuesta. En él asegura que el uso de animales es esencial para los ensayos de nuevas medicinas. También afirman que ha desempeñado un papel crucial en el desarrollo de las vacunas efectivas contra el Covid-19.

“Las imágenes han sido editadas – y pediríamos que las imágenes sin editar se hicieran públicas – EARA reconoce que lo que ha sido mostrado hasta ahora revela ejemplos de estándares de bienestar animal inaceptables, aplicados a varias especies animales distintas”, explicó Kirk Leech, director ejecutivo de EARA.

Como explica la anteriormente nombrada, Directiva 2010/63, sus medidas tienen como objetivo limitar la experimentación con animales a un mínimo absoluto y establecer normas obligatorias sobre su uso, alojamiento y cuidado. Los altos estándares de bienestar animal benefician tanto a los animales como a la ciencia.

Lo cierto es que las empresas productoras de bienes de consumo deberían tener en cuenta desde los ingredientes, hasta el envasado, pasando por la salud humana, animal y del medioambiente. ¿Cuántos a la hora de comprar un producto, piensan en el recorrido que el mismo atravesó hasta llegar a la góndola?

Siendo hoy en día la variedad de productos infinita y así mismo la de elecciones, ¿Debemos responsabilizar 100% a estas empresas? ¿O, el consumidor también debería tomar cartas sobre el asunto y elegir con conciencia?

El impacto será lento pero eficaz si en cada elección, apostamos por un producto que no dañe al medioambiente ni a los animales.
"
6/08/2021,News,143,82,50,6,281,Se dejarán de vender coches de combustión para el 2035,"2035 es la fecha límite para la venta de vehículos a gasolina y diésel, según informó la Comisión Europea. Con el fin de reducir la huella de carbono, los coches de combustión se dejarán de comercializar y aquellos que se produzcan en la Unión Europea tendrán que ser de cero emisiones. 

Minimizar las emisiones de CO2 de la industria automovilística es uno de los grandes objetivos actuales. Aunque aún faltan varios años, el escenario de este sector cambiará para siempre. El objetivo es que para la mitad de siglo no circulen más coches a gasolina y diesel, ni habrá tolerancia hacia los híbridos. Se espera que estos últimos desaparezcan del mercado, según asegura Antena3.

Se requiere de infraestructura eléctrica para que desaparezcan los coches a combustión  
La Comisión Europea propone que en las rutas principales haya estaciones de carga para vehículos eléctricos cada 60 kilómetros.

¿Estamos preparados para esta transformación? En España, por lo menos, aún falta infraestructura de puntos de carga para el transporte eléctrico. En todo el territorio nacional existen 11.517 puntos de recarga de acceso público, según Electromaps. 

La Asociación Española de Fabricantes de Automóviles y Camiones (ANFAC) y Faconauto, presentaron un mapa de despliegue de puntos de recarga de acceso público para vehículos electrificados. En él es visible la necesidad de tener instalados como mínimo 340.000 puntos de recarga públicos para 2030. El fin de esta hoja de ruta es acelerar el despliegue del vehículo electrificado de aquí a 15 años.

Las emisiones serán nulas sólo si la energía utilizada para los coches eléctricos es 100% renovable
Si bien el foco está puesto en que los coches no deben emitir más CO2, la realidad es que la energía que se vaya a usar para su funcionamiento también debería ser renovable. Es decir, que los coches eléctricos no contaminen directamente ni indirectamente al planeta. Solo así el cambio podrá ser real y efectivo para el medioambiente. 
De cada diez coches eléctricos, cuatro funcionan con energías que no contaminan, según Mueveteenverde.es. El 44% del total de las energías han sido verdes en el 2020. Este año van en aumento, aseguran desde la REE, más de la mitad (51,5%) de la electricidad producida en lo que va del 2021 es de origen renovable. Pero para lograr llegar a la meta de 0 emisiones, las empresas encargadas de la electrificación deberán brindar energía limpia de la A a la Z. 

Bruselas se ha propuesto llegar a una cuota del 40% de renovables como mínimo a finales de esta década, persiguiendo llegar a la neutralidad climática para 2050. Así poder llegar a la neutralidad climática para el 2050. Así, las probabilidades de que los coches se abastezcan de energía renovable van en ascenso.

Todavía queda tiempo, aún así son muchas las preguntas que nos invaden a los ciudadanos. ¿Qué sucederá con todos los coches de combustión? ¿A dónde irán a parar? ¿Serán accesibles los vehículos eléctricos para todos? Sólo queda esperar para conocer las respuestas."
17/08/2021,News,167,27,29,6,229,Se presenta el Plan de Acción de Educación Ambiental,"Hace unas semanas, el Ministerio para la Transición Ecológica y el Reto Demográfico elaboró el Plan de Acción de Educación Ambiental para la Sostenibilidad (PAEAS), que busca cambiar la forma en que se relacionan las personas con su entorno, según informó el Consejo de Ministros. Modificar la manera en que se desenvuelven los ciudadanos en su ecosistema posibilitará acelerar la transición ecológica.

Este plan es una hoja de ruta de aquí a 5 años sobre las políticas en las que se deberá trabajar para hacer frente a los desafíos climáticos y ambientales.

Impulsar la información y concienciación de la sociedad es el principal objetivo. Con él se busca aumentar la participación de la gente en el proceso de toma de decisiones. También se busca fortalecer el papel de la educación ambiental, considerada por muchos como la herramienta para la transformación que la emergencia climática requiere. 

La importancia de la educación ambiental en el sistema educativo
Se han propuesto 6 Ejes Operativos, que pretenden aportar soluciones a los problemas a los que se enfrenta hoy el país. Entre ellos, la integración de la sostenibilidad en el sistema educativo y formativo; y la divulgación, comunicación y acción ciudadana.

El sistema educativo es uno de los principales instrumentos para crear una ciudadanía participativa, informada, capacitada y comprometida con el medio ambiente. Para que esto sea posible, es necesario que profesores y docentes accedan a formación que les permita incorporar la sostenibilidad en toda su actividad educativa, asegura el PAEAS.

Actualmente, la educación ambiental se trabaja desde que los niños empiezan la escolaridad, explica Montse Campeny, maestra de primaria de una escuela pública de Sant Adrià de Besòs. A medida que van avanzando los cursos, se va aumentando el contenido. “Nuestra escuela está creando el proyecto Escola Verda, el cual nos ayudará a trabajar mejor todo lo relacionado con la educación medioambiental. Tocamos todos los aspectos, desde el más cercano, la clase y la ciudad, hasta los más técnicos conforme avanzan los cursos”, asegura la maestra Campeny.

Si bien fomentan el correcto uso del papel y su reciclaje, dan clases con luz natural y tienen grifos automáticos, para Montse se deberían prohibir los envases de un solo uso, ya que siguen generando muchos desechos en las escuelas. 

Darle seguimiento al plan para asegurar una correcta transición ecológica
Lo que queda es ver cómo se ejecutará este plan. Desde SEO Birdlife explican que: “Debemos prever cómo se ejecuta ese plan, también a nivel de financiación. Hay que trabajar los indicadores para evaluar que todas las acciones que se plantean estén”.

Como toda idea que se desarrolla a nivel nacional, luego debe plasmarse en cada Comunidad autónoma. El desafío estará en qué dotación económica se dará o tendrá cada una y cómo se llevará a cabo dicho plan.

Aunque suene un tanto cliché: la educación es la base de todo, o casi todo. Incorporar educación medioambiental en las escuelas es una necesidad urgente; tanto para cumplir con los planes europeos y la Ley de Cambio climático, como para lograr relacionarnos con nuestro entorno de una manera respetuosa y consciente."
4/03/2020,News,64,12,0,21,97,Si no te preocupa la crisis climática es porque no han sabido contártela,"Aunque seamos conscientes de que el planeta tiene unos límites, nos cuesta vivir de una forma sostenible. Nuestros sesgos cognitivos tienen parte de culpa. Hasta ahora, los profesionales de la comunicación no han hecho más que reforzarlos al crear un relato sobre el cambio climático que nos deja fríos.
Lucas Sánchez, Ex-investigador en CSIC. Co-fundador de @Scienseed, autor de http://sonicando.com y la novela http://impostores.es explica para SINC cómo actúa nuestro cerebro frente a la crisis climática. A continuación, compartimos parte de sus reflexiones:

Si metemos unas pocas bacterias en un matraz lleno de medio de cultivo, sabemos con seguridad que se dividirán de forma imparable, duplicando su población cada veinte minutos. Este ritmo de crecimiento para ellas es insostenible, pero son seres unicelulares que no pueden hacer otra cosa que agotar todos sus recursos mientras su población aumenta exponencialmente.

Que nosotros sepamos, las bacterias no ven el cristal, ni piensan bien en el futuro y, por lo tanto, no pueden imaginarse una vida sostenible.

Si dibujamos un gráfico de su crecimiento, sería muy parecido al del ser humano desde la revolución industrial, salvo por su escala: minutos equivaldrían a años. Y, por mucho que nosotros sí podamos ver que nuestro planeta tiene unos límites y sepamos que no podemos huir mucho más allá, nos cuesta vivir de una forma sostenible. Una incapacidad marcada por taras presentes en nuestros sobrevalorados cerebros: nuestro órgano más distintivo es prácticamente ciego al cambio climático. No le importa aquello que percibimos como algo lejano en el tiempo o en el espacio. De hecho, solamente nos permite tenerlo realmente presente en días de eventos climáticos extremos. No le gusta lidiar con la incertidumbre, y la huele cada vez que los científicos actualizan los impactos conforme avanza su conocimiento. Además, no entiende como peligroso algo que no es personal, ni abrupto, ni inmoral.

Palabras que no nos dicen nada
Históricamente, la comunicación del cambio climático no ha hecho más que alimentar estos sesgos y ayudar, en cierta medida, a conducirnos a la situación actual. 

Empezando por el oso polar en un trozo de hielo a la deriva, una imagen recurrente e impactante que lanza un mensaje dramático. Y funciona estupendamente para que lo recordemos y lo compartamos. Lamentablemente, funciona fatal a la hora de ayudarnos a hacer algo. Diversos estudios indican que mensajes negativos y atemorizantes solo nos paralizan. Además, el oso polar, para una inmensa mayoría, está lejos, reforzando la distancia psicológica. 

Durante años ha primado la terminología más aséptica posible para hablar sobre este complejo proceso: cambio climático. ¿Se acuerdan del calentamiento global? Pues esa expresión no la querían ni los republicanos en campaña, ni los científicos. Unos porque les convenía, y otros, por purismo: calentamiento global no definía todas sus causas y consecuencias.

Ahora estamos intentando llamarlo emergencia climática, pero puede generar problemas llamar “emergencia” a algo que no sentimos como tal. Es sobrealimentar el efecto de “Pedro y el lobo” que llevamos a hombros desde hace años. “Emergencia” no es una palabra que funcione bien el día que vuelve a salir el sol después de una inundación. “Emergencia” no es a lo que huele el nuevo césped que crece donde hubo un incendio. 

Ni de derechas ni de izquierdas
Nos hemos conformado históricamente con personajes con mucha popularidad que podían amplificar el mensaje, pero no pensamos si esa persona lo contaminaba ideológicamente. Que la causa quede politizada es grave, porque nuestro cerebro procesa lo que nos creemos en bloque. Los seres humanos entendemos mejor el mundo en grupos de cosas y rechazamos las ideas que pertenecen al grupo contrario. 

Acción política, solución científica
Desde la comunicación, lo más alto que se puede llegar es a convencer al cerebro de quienes nos dirigen, para que tomen medidas drásticas que sí puedan ponerle freno. A fin de cuentas, el cambio climático es un problema político: afecta gravemente a la economía, a la salud pública y a la seguridad nacional. Y mencionarlo como tal puede permitir, de nuevo, dar un empujoncito para que los políticos apuesten por invertir en el desarrollo de soluciones científico-tecnológicas. 

Porque quizás la única manera de salir de esta crisis climática es encontrar una fórmula científica que equilibre la balanza. Y los mejor preparados para sacar ese remedio fantástico de una chistera son los mismos que han estudiado cómo el efecto invernadero produce un calentamiento global, cómo nos engaña nuestro cerebro, o cada cuánto duplican su población un puñado de bacterias agitándose en un matraz de cristal. Quizás así corramos mejor suerte que ellas."
19/08/2021,News,207,47,41,9,304,Turismo espacial: viajes para pocos que afectarían a muchos,"La puja millonaria por llevar turistas al espacio podría afectar negativamente a nuestro planeta. El turismo espacial generaría gases de efecto invernadero y contaminaría el aire de la Tierra. ¿Vale la pena el disfrute de unos pocos por sobre la salud de nuestra atmósfera?

Todos hemos soñado alguna vez en conocer el espacio y ver la tierra desde arriba. Suena maravilloso, pero lamentablemente es una fantasía que solo una ínfima parte de la población mundial podría hacer realidad. 

Hay tres magnates en la búsqueda de ser los primeros en proporcionar estos paquetes turísticos. Por un lado, Richard Branson, con su avión espacial Virgin Galactic VSS Unity pilotado. Luego, Jeff Bezos y su cohete autónomo Blue Origin. Y Elon Musk con su cápsula Crew Dragon.

Estos viajes turísticos al espacio concederían a los pasajeros una breve aventura de diez minutos en gravedad cero y la posibilidad de vislumbrar la Tierra desde el espacio, explican en la BBC. El valor tan elevado de esta travesía hará imposible que una gran mayoría de las personas puedan acceder a ella.

Durante un vuelo espacial se amplifican las emisiones de CO2
La huella de carbono que dejarían los turistas en un vuelo espacial será hasta 100 veces más de las emisiones que ya produce un pasajero en un vuelo comercial de larga distancia. Según el portal Actualidad Aeroespacial, en 2020 estos tipos de vuelos en avión produjeron un 48% de CO2.

El lanzamiento de un cohete puede emitir hasta 10 veces más óxido de nitrógeno que la planta de energía térmica más grande de Reino Unido, aseguran en la BBC. Estas emisiones atrapan el calor en la atmósfera, lo cual aporta al calentamiento global.

Bezos asegura que sus cohetes son más ecológicos que el resto. El cohete que se lanzó al espacio utilizó hidrógeno líquido y propulsores de oxígeno líquido, mientras que el de Branson, usó un propulsor compuesto por combustibles a base de carbono y óxido nitroso, entre otros. La quema de estos, genera GEI que contaminan el aire. Además de que los gases que se liberan a más de 80 km de altura, quedarían “atrapados” ahí al menos por 3 años.

¿Cómo se desarrollará la industria del turismo espacial?
Aún faltan estudios para averiguar cuales son los efectos generales de mandar estos cohetes al espacio. Ahora bien, este nuevo negocio acarrea una nueva industria. Es importante que los expertos conozcan bien los efectos que producirán los viajes espaciales sobre nuestro planeta, para poder controlar y regular esta industria.

Lo que ya está preocupando a los expertos, según France24, es que la industria del turismo espacial se vuelva más accesible para la gente. Así se aumentaría la cantidad de gases de efecto invernadero expulsados directamente en nuestra atmósfera. 

El paso del tiempo dejará en evidencia si los viajes al espacio serán un problema más a resolver para enfrentarse a la crisis climática."
23/08/2021,News,301,50,120,3,474,Un nuevo sistema pone freno a los residuos en el mar en Cataluña,"Se trata de un sistema de mallas integrado en los colectores de agua residuales que se encargará de gestionar los residuos en el mar en Cataluña. Este recogerá entre 3 y 5 toneladas anuales de residuos urbanos en cada punto instalado y evitará que acaben en playas y mares.

La empresa catalana TecnoConverting Engineering, dedicada al tratamiento de aguas, ha sido la encargada de desarrollar el proyecto. Ya se ha realizado una prueba piloto en Sabadell, en la que cada malla ha atrapado más de 100 kilos de residuos acumulados después de tres episodios de lluvias. Durante un año, se han recogido más de 2,7 toneladas de residuos. Por otro lado, en Tarragona, se espera recoger 5,5 toneladas anuales de residuos, según informa el portal Residuos Profesional.

Tecno Grabber es el sistema que promete poner fin a los residuos en el mar en Cataluña
Conocido como ‘‘Tecno Grabber’’, este sistema está basado en un conjunto de mallas en forma de tubo instaladas en colectores de aguas residuales. Estas filtran las aguas y atrapan todos aquellos residuos sólidos que por alguna razón terminan en los sistemas de alcantarillado. Cada maya tiene una distancia de dos metros de largo, son reutilizables y están realizadas de materiales de alta resistencia para evitar su rotura. Tienen una gran utilidad en episodios de lluvias torrenciales y se estima que cada municipio donde se instale podrá registrar cantidades de limpieza de residuos próximas a las 1.000 toneladas.

Esto podría suponer un gran respiro para las zonas de costa catalanas, que cada año registran las graves consecuencias de una mala gestión de residuos sólidos volcados al mar. El pasado mes de marzo, según un estudio de la Red de Seguimiento Ibérico del Litoral Marino, la playa de la Mar Bella, en Barcelona, registró una media de 1.700 residuos por cada milímetro de playa, según informa El Periódico.

La contaminación costera: Un mal que nos afecta a todos
Se estima que de todos los residuos sólidos recogidos, un 15% acaba llegando al mar. El uso de las zonas de costa para uso recreativo incrementa ese porcentaje hasta un 80%. Y se registran altas cantidades de plásticos en el fondo marino, que terminan ahogando la flora y fauna marina que lo habitan.

La problemática dada en marzo en la playa de la Mar Bella es una de las muchas que el litoral catalán registra año tras año. En junio de 2021, saltaban todas las alarmas en la playa de Sant Adrià del Besòs, por una peligrosa contaminación en su zona costera.

Una falta de compromiso medioambiental y fuertes episodios de lluvias torrenciales han llevado a estos municipios catalanes a actuar rápidamente sobre la contaminación por residuos en sus playas."
27/09/2021,News,249,70,67,12,398,Un tercio de las especies de tiburones están en peligro de extinción,"Según la última actualización de la Lista Roja de la Unión Internacional para la Conservación de la Naturaleza (UICN), un tercio de las especies de tiburones en el mundo se encuentran en peligro de extinción. ¿La razón principal? La sobrepesca. Se encuentran en extrema vulnerabilidad a la sobrepesca porque su crecimiento es muy lento y no tienen muchas crías.

Los tiburones son una de las especies más temidas por el ser humano pero la realidad es que la cantidad de muertes ocasionadas por estos animales anualmente es demasiado baja para toda la mala fama que acarrean. El año pasado se reportaron un total de 120 ataques de tiburones a humanos, según el informe anual del Archivo Internacional de Ataques de Tiburones (ISAF) de la Universidad de Florida (EEUU).

Parece que este miedo está contribuyendo indirectamente a su desaparición en nuestros océanos. Según National Geographic, los seres humanos se preocupan más por aquellas especies que despiertan algún grado de empatía. Los tiburones no serían el caso.

La sobrepesca es la principal amenaza de las especies oceánicas
Los tiburones son muy sensibles a la sobrepesca dada su tendencia a la madurez tardía y su baja tasa de reproducción, según la UICN. Estos animales muchas veces quedan atrapados en las redes de pesca. “Sobre todo se quedan atrapadas las crías en los agujeros de la red. Suele pasar que cuando los pescadores ven tiburones atrapados, en lugar de devolverlos al agua, los dejan morir», asegura la Dra Marianne Bizzozzero.

En la mayoría de los casos, las capturas de los tiburones ni están reguladas ni son sostenibles. Se podría decir que en muchas aguas no existe la ley, se vuelve muy difícil de controlar que es lo que está sucediendo durante la pesca intensiva. Los investigadores que participaron del informe del UICN acusan a los gobiernos de no seguir los “consejos científicos” para minimizar la mortalidad y terminar de una vez con la explotación insostenible.

Los efectos de la crisis climática se ven reflejados en la extinción de los tiburones
A los problemas de la sobrepesca, se le suma el cambio climático. Cuando cambian las corrientes, los tiburones se acercan más a las costas. Como resultado, salen a matarlos y pescarlos. 

Su sobreexplotación ha desbordado la gestión eficaz de los recursos, según el análisis, además de la destrucción progresiva de su hábitat por los efectos del cambio climático y la contaminación. “Otro punto que agrava la situación es la agricultura convencional, que contamina el océano. Los pesticidas terminan en el agua, cambiando los niveles de oxígeno y creando un hábitat no habitable”, explica la Dra. Bizzozzero.

En conclusión, para evitar que desaparezcan estas especies y se siga dañando su ecosistema, la UICN sugiere establecer límites a la pesca basados en la opinión de los científicos. De todas maneras, hace ya décadas que la vida de los tiburones se encuentra en peligro y parece que no se hace nada al respecto."
15/01/2020,Opinion,60,23,3,21,107,¿Serán los centennials la esperanza que el mundo necesita?,"“La generación Z cambia al mundo” mientras la generación Y disfruta de la vida, según un informe de Think with Google. 

El planeta se encuentra en un punto del que no hay retorno. La falta de políticas alrededor del mundo que legislen a las grandes corporaciones en cuanto a cómo afectan sus actividades a la tierra, puede llevarnos a pensar que en breve tendremos un punto final. Los resultados de la COP25 lo dejaron en claro: los planes se postergan a la próxima convención. 

En este contexto, comenzaron a aparecer voces más jóvenes pidiendo un cambio urgente. ¿Será la última generación quien logre el cambio?

Los nacidos a partir de los 2000, que ya son un tercio de la población mundial, y cuya capacidad económica va en aumento, son grandes tomadores de decisiones actualmente según la agencia Bloomberg, y quienes definirán el destino de la tierra pronto. 

“Las oportunidades y amenazas del mundo moderno han hecho que las generaciones Y y Z tengan diferentes formas de enfocar la vida” cuenta el informe. Añade, que los centennials, tienen una visión más ambiciosa de la vida. Un 60% de ellos, frente a un 39% de los millennials, quiere mejorar el mundo en el que vivimos. Lo interesante de esta generación además, es que, no sólo tienen estos ideales; también creen en su capacidad para cumplirlos. 

Al haber nacido en un entorno completamente digital, dominan la tecnología, saben cómo obtener información y discernir si es verdadera o falsa. Entre sus características -hablando en términos generales- son seguros de sí mismos y “esperan que los demas (marcas, compañeros o suscriptores) los tomen en serio”. 

Todos estos rasgos hacen de la generación Z, la esperanza del mundo."
8/07/2021,Opinion,162,15,3,3,183,‘Rebuilding Paradise’: historia de un incendio,"El documental pone sobre la mesa la importancia de los incendios naturales como herramienta de equilibrio para los ecosistemas
Con motivo de la Celebración del Día Mundial del Medio Ambiente, el Festival de Cine SUNCINE de la mano de ONU Medio Ambiente de México y Promotora Ambiental recuperaron las películas ganadoras de la 27a edición del festival. Su objetivo era concienciar a la ciudadanía de la realidad del planeta en busca de un cambio de los hábitos perjudiciales para el medioambiente. Esta vez con la historia de un incendio en la costa oeste de Estados Unidos. 

‘Rebuilding Paradise’, un documental dirigido por Ron Howard
El Festival organizó una sesión gratuita en la Filmoteca de Catalunya donde se visionaba el documental Rebuilding Paradise. Además, se concluyó con un coloquio junto a la Fundación Pau Costa, especializada en incendios. El documental explica la historia real de un incendio vivido en 2018 en la urbanización de ‘Paradise’ de San Francisco. El documental nos explica que la causa puede ser en parte un problema en la instalación eléctrica de ‘Pacific Gas & Electric’ que pasa por la urbanización. Sin embargo, uno de los miembros de la Fundación Pau Costa explicó en el coloquio que sus causas son múltiples, pues también se puede catalogar de incendio natural. La principal evidencia es el hecho de que el fuego destruyera las casas pero no las copas de los árboles, por falta de gravedad. Este hecho demuestra como el mismo incendio podía tener la finalidad de buscar el propio equilibrio de la naturaleza y que si no fuera porque había construcciones humanas no hubiera habido daños. 

El film deja una sensación agridulce. Por un lado, la satisfacción al ver que las propias familias son capaces de pasar página y seguir con su vida tras un incendio que ha arrasado con todo lo que tenían. Por otro lado, intranquilidad por aquellas que tras un incendio de tal magnitud deciden volver a vivir en la zona, aunque les estén avisando de que se trata de un terreno de alto riesgo de incendio. 

El Festival SUNCINE
A parte de este pase presencial, SUNCINE habilitó una página web dónde se podían visionar de manera virtual otras películas y documentales relacionados con el medioambiente. Sin embargo, la próxima edición del Festival Internacional de Cine de Medio Ambiente ya ha abierto inscripciones para las candidaturas. No será hasta la semana del 3 al 11 de noviembre que las conozcamos. Y posteriormente, a la ganadora que se llevará el galardón del Sol de Oro como Premio al Cine Sostenible."
1/10/2020,Opinion,155,9,0,6,170,"Agenda 2030, ¿Se podrá conseguir?","‘El cambio climático’ es una de las respuestas más frecuentes a los problemas que afectan al medio ambiente. ¿La temperatura del planeta aumenta? Es el cambio climático. ¿Los polos se derriten y el nivel del mar aumenta? El cambio climático. ¿El clima es cada vez más tropical? El cambio climático. Parece ser que todo aquello que rodea al desequilibrio actual del planeta es causa del cambio climático y, sí, así es, pero ¿cómo podemos frenar el cambio climático? La Agenda 2030 es la solución.

La ONU ha creado la Agenda 2030 para el Desarrollo Sostenible de los países miembros. Este es un compromiso que todos los países deberán cumplir antes del próximo 2030.

Esta agenda se aprobó en 2015 por todos los dirigentes mundiales. 5 años después la lectura no es favorable. 2019 ha sido el segundo año más caluroso de todos los tiempos, y la década de 2010 a 2019 es hasta el momento la década más calurosa de la historia. Además se ha registrado un aumento récord en los niveles de dióxido de carbono (CO2) y otros gases de efecto invernadero.

""Las reducciones de emisiones de carbón en el punto máximo de las medidas de confinamiento por el coronavirus alcanzaron hasta un 17%, pero ya se acercan de nuevo a los niveles previos a la pandemia y a largo plazo no tendrán mucho impacto en las concentraciones de gases de efecto invernadero en la atmósfera, que permanecen en niveles récord"" de acuerdo a la ONU.
La Agenda 2030 trata una diversidad de temas entre los cuales están el cuidado del medio ambiente, la pobreza y la igualdad de género. El Punto 13 ‘Acción por el clima’ es aquel que detalla los objetivos relacionados con una solución para mejorar el planeta que dejaremos a las generaciones futuras. Algunos de ellos son:

Fortalecer la resiliencia y la capacidad de adaptación a los riesgos relacionados con el clima y los desastres naturales en todos los países.
Incorporar medidas relativas al cambio climático en las políticas,estrategias y planes nacionales.
Mejorar la educación, la sensibilización y la capacidad humana e institucional respecto de la mitigación del cambio climático, la adaptación a él, la reducción de sus efectos y la alerta temprana.
La Unión Europea ha marcado los objetivos que se han de conseguir en 2030 para dar por cumplida esta Agenda mundial. Reducir un 40% los gases de efecto invernadero registrados en 1990 es un objetivo principal. Para conseguirlo, se propone “acelerar la transición hacia una economía hipo carbónica que abarque todos los sectores de la economía de la UE” y reducir a mínimos las emisiones de CO2.

Las políticas institucionales y la acción ciudadana son imprescindibles para llegar a estos objetivos. Para reducir las emisiones de CO2 es necesario reducir el uso del transporte privado, o su reemplazo por vehículos híbridos o eléctricos. Además, es importante reducir los viajes internacionales con aviones u otros vehículos que supongan tal cantidad de contaminación atmosférica. Actualmente, el 5% de la contaminación es causa de la aviación. Según Ecoembes, el sector del transporte supone el 25% de la contaminación atmosférica de España.

Todos los datos muestran como la contaminación de la última década solo ha ido en aumento. Ha llegado el momento de frenar la situación actual y reducirlos niveles registrados hasta hoy día. Para conseguirlo, debemos dar solución a algunos de los problemas actuales a nivel mundial como puede ser la producción de gases de efecto invernadero del sector ganadero o el consumo excesivo de alimentos."
14/04/2020,Opinion,49,38,0,3,90,Agroecología en tiempos de Covid-19,"Varios cambios se vienen advirtiendo en la naturaleza como consecuencia del Covid19. La disminución en la contaminación del aire, la aparición de fauna en centros urbanos y la cristalización del agua, entre otros. Este virus llama a la humanidad, a repensar el desarrollo capitalista y a cuestionarse la forma en que se relaciona con la naturaleza. Una vez más, queda al descubierto el estrecho vínculo entre la salud humana, animal, de las plantas y la ecología.

Esta pandemia invita a analizar la relación entre la agricultura y la salud, reconociendo el enfoque sistémico de la agroecología. Esta última puede fomentar el bienestar, entretanto se eviten los procesos industriales, los cuales pueden generar grandes riesgos y daños para la salud.

El 80% de las 1500 millones de hectáreas cultivables en todo el mundo son ocupadas por monocultivos a gran escala, los cuales carecen de diversidad ecológica y son muy vulnerables a las plagas. Para hacerle frente a esta situación, se aplican anualmente 2300 millones de kilogramos de pesticidas, produciendo daños ambientales y efectos tóxicos agudos y crónicos en la salud, a costos económicos muy elevados.
¿Por qué la desprotección de agropaisajes abre la puerta a las pandemias?
El factor agravante es el reemplazo de agropaisajes biodiversos por grandes áreas de monocultivos. Cuando se origina la deforestación los organismos migran a las urbes desde los bosques. Como resultado de las actividades de la agricultura industrial y el uso de agroquímicos e innovaciones biotecnológicas, enfermedades que previamente eran controladas por ecologías forestales de larga evolución en hábitats naturales, son liberadas alcanzando las poblaciones. 

Con las actividades paralizadas la debilidad del sistema alimentario globalizado sale a la luz.
Las restricciones al transporte impiden la llegada a destino de alimentos importados, ya sea de otra región del mismo país. Así es como en el ámbito alimenticio, las consecuencias son fatales, principalmente para aquellos países que importan más del 50% de los alimentos que consume su población. De esta manera, queda al descubierto la insostenibilidad de este sistema alimentario y su vulnerabilidad frente a factores externos como desastres naturales o pandemias. 

La transición hacia una agricultura agro es vital para proporcionar beneficios sociales, económicos y ambientales a las familias rurales. Este modelo tiene la capacidad de alimentar a las masas urbanas equitativamente y de forma sostenible. Promover nuevos sistemas alimentarios locales es urgente para garantizar la producción de alimentos abundantes, saludables y asequibles para una creciente población humana urbanizada. 

¿Cuál sería la solución de la mano de este sistema? ¿De qué manera contribuiría a la disminución de posibilidad de nuevas pandemias?
Dentro de los pilares de la agroecología se plantea restaurar los paisajes que rodean los campos. Esta medida conduce al enriquecimiento de sus funciones como el control natural de las plagas, la conservación del agua y suelo, la regulación climática y biológica, entre muchas más. Con el restablecimiento del paisaje también se impide la salida de patógenos de sus hábitats. La producción ganadera sana es también una arista donde la agroecología pone su foco. En ella, los animales son provistos de alimentos naturales provenientes de suelo sanos sin hacer uso de antibióticos, reforzando así sus sistemas inmunitarios.

Este es un gran momento para reflexionar sobre cómo y qué se consume. El aporte de la agroecología contribuye a la nutrición de las familias locales con alimentos nutritivos de origen vegetal y animal producidos en fincas agroecológicas. Al mismo tiempo protege al sistema inmunológico mejorando su capacidad de resistirse frente amenazas, incluidos los virus contagiosos como el Covid-19.  

Sin lugar a dudas, en un mundo donde el cambio climático pisa fuerte y una pandemia dijo presente, la agroecología tiene el potencial para abastecer gran parte de los alimentos necesarios en comunidades urbanas y rurales. Sin embargo, su desarrollo recae sobre el compromiso del principio de la economía solidaria donde existen oportunidades equitativas de mercado local y regional. Aquí es donde la participación de los consumidores es fundamental, ya que debe entenderse que el apoyo a los agricultores locales, en lugar de a cadenas alimentarias corporativas, crea sostenibilidad. El mensaje es claro, comer es un acto ecológico y político. El cambio en los gobiernos llevará tiempo, por lo cual, el poder de generar el cambio es de los consumidores, haciendo elecciones diarias apoyando a los pequeños agricultores, al planeta y a su propia salud.

Los ecosistemas sostienen las economías (y la salud), pero las economías no sustentan los ecosistemas. El Covid-19 ha llegado para poner al mundo en pausa, recordando que cuando el tratamiento sobre la naturaleza es desconsiderado, este tiene consecuencias profundas perjudicando también a los humanos."
18/09/2020,Opinion,415,84,21,9,529,"Ansiedad en era Covid19, y cómo curarla","Hay una palabra en nuestra nueva normalidad que ha aumentado el número de veces que podemos mencionarla al día. Hemos tenido que aprender a vivir improvisando por una pandemia que ha dejado a todo el mundo paralizado. Esta situación nos enseña, entre otras cosas, a apreciar y disfrutar de aquellas cosas que pasaban de puntillas por nuestros días de rutina y ajetreo.

Ya vivas en una gran ciudad, o en un pequeño pueblo de pocos habitantes, vivir con incertidumbre es algo que, poco podríamos llegar a imaginarnos, en el siglo XXI. Además de, vivir en unos tiempos donde, la información la tenemos al alcance de nuestra mano con un simple ‘’click’’. Seguramente, la palabra que te voy a mencionar ahora, también sea, una de las más buscadas en Google. Y es: ‘’Ansiedad’.

La ansiedad se caracteriza por ser un estado mental en el que destaca la inquietud y una extrema inseguridad hacia algún factor externo. Ese factor externo, nuestro organismo, lo reconoce como una alerta o una amenaza. Y nos prepara para una situación de ‘’supervivencia’’. Digamos que, en estos tiempos, la pandemia sería ese ‘’algo’’ a lo que nos enfrentamos y queremos sobrevivir a ella. A continuación, te mostramos cómo se origina, cómo y por qué se manifiesta en nuestro cuerpo:  En el mundo, son alrededor 264 milliones de personas, ya sufren trastornos de ansiedad. La OMS, ya ha advertido que, esta cifra ha aumentado debido a la situación que atravesamos. Y con una mayor prevalencia en países más afectados por el virus. Además, esta ansiedad podría acabar desembocando, también, en muchos casos de lo que ahora se conoce como: ‘’El síndrome de la cabaña’’. Este síndrome se caracteriza por, un miedo irracional a ser contagiados, así como a relacionarnos con la gente. Este síndrome, no está reconocido como patología, sino más bien, es un efecto colateral de los confinamientos  impuestos en todas las partes del mundo.

Desde EcoNews Today, te contamos sobre algunas prácticas para conectarte con el medio ambiente y ayudar a reducir la ansiedad.

Practica deporte: Está comprobado que el deporte tiene efectos muy positivos frente a situaciones de ansiedad. Durante su práctica se liberan endorfinas. Estas hormonas, potencian el buen humor, hacen que te sientas mejor contigo mismo, y tienen un poder curativo sobre la ansiedad.
Camina: Al igual que hacer deporte, caminar y el medioambiente, son una fórmula buenísima para hacer que tus niveles de ansiedad se reduzcan. Ya vivas cerca de la playa o de la montaña, puedes salir a andar unos 30 minutos. La práctica del caminar, activa tu sistema cardíaco, haciendo que junto con la respiración, la ansiedad desaparezca por un rato.
Desarrolla tu parte creativa: Potenciar la creatividad en estos tiempos es una de las mejores actividades que existe. Pintar, dibujar o coser, están consideradas actividades de concentración, por lo que, si prestas atención a la actividad, no darás cabida a la ansiedad.
Decora tu hogar y ten plantas: Seguro que conocerás a alguien que haya desarrollado la profesión de carpintero, decorador o jardinero a raíz de la pandemia. Estas actividades también ayudan al entretenimiento y la creatividad Así mismo, como tener plantas en  nuestro hogar, nos servirá para crear una pequeña conexión con el medioambiente en nuestra zona de confort. Además, tener cuidado de ellas, nos ayudará a despejarnos de nuestras preocupaciones. Y nos aportarán vitalidad y alegría en nuestros hogares.
Haz yoga, pilates o mindfullness: Consideradas actividades de relajación, son un maravilloso antídoto para gestionar los niveles de ansiedad. Son una combinación de deporte y aprendizaje de nuestro cuerpo y respiración. Además, está comprobado que, si estas prácticas se hacen al aire libre, el efecto en nuestro organismo, es mayor.
Recurre a un profesional: Si has probado con técnicas y no han funcionado, o sientes que la ansiedad te desborda, no dudes en visitar a profesionales de la salud mental. Ellos te ayudarán a gestionar la ansiedad y a liberarte de preocupaciones que se han hecho mayores con esta situación que estamos viviendo. Ellos te escucharán y te darán recursos para aprender más sobre la gestión de la ansiedad.
Está comprobado que el medio ambiente tiene grandes beneficios para nuestro bienestar. ¡Aprovéchalo!"
8/03/2021,Opinion,645,231,3,6,885,Cambios en las ciudades europeas post-pandemia,"El estallido de la pandemia de COVID-19 en marzo de 2020 ha puesto en jaque la concepción que se tenía del desarrollo de las ciudades. Jefes de gobierno, arquitectos y urbanistas han abierto una serie de debates sobre las características de las ciudades post-pandemia, así como también qué medidas se deberían adoptar para garantizar un entorno urbano más seguro, sostenible y equitativo. 

Las nuevas tendencias urbanas provocadas por la crisis sanitaria están impactando en la dinámica de las ciudades.

Te contamos los destacados:

Urbanización sostenible
Desde ONU Habitat se ha resaltado la importancia de la urbanización sostenible en la recuperación post COVID. Un desarrollo planificado y bien gestionado puede acelerar el crecimiento económico, la reducción de desigualdades y el impacto ambiental producido por los modelos de producción actuales. Así, se lograría un desarrollo de las urbanizaciones más sostenible.

Ciudades compactas y de 15 minutos
Si bien ambos conceptos no son equivalentes, tienen algunos puntos en común a destacar como alta densidad poblacional, distancias de viaje cortas, reducción de desigualdades, medios de transporte ecológicos y disminución de emisiones de CO2. 

Nuevas regulaciones
Los nuevos requerimientos traerán aparejada la necesidad de modificar las reglas establecidas. Es necesario que se adquiera un enfoque que tenga en cuenta aspectos de sostenibilidad, habitabilidad, salud y equidad. Por ejemplo, la regulación para los nuevos desarrollos urbanos debería incluir indicadores de impacto en la salud, teniendo en cuenta los niveles de contaminación auditiva, visual y del aire.

El 2020 ha sido un año que ha roto los esquemas establecidos y ha puesto de relieve la necesidad de repensar los modelos económicos y la forma en que vivimos. También, como expresó el Secretario General de ONU, “es necesario poner a las comunidades en el corazón de las ciudades del futuro, empoderarlas para que participen en la toma de decisiones y políticas en pos de obtener resultados más inclusivos y duraderos”. 

Las transformaciones continuarán y se las deberá enmarcar en un contexto cada vez más amigable con el plantea."
5/02/2020,Opinion,206,59,3,9,277,Esto no es un simulacro: estamos en crisis climática y ecológica,"Esto no es un simulacro. Hoy se encuentra en peligro el alimento que consumimos, la tierra que cultivamos y el aire que respiramos (Extinction Rebellion, 2020). Es un hecho que estamos amenazando los servicios ambientales básicos que nuestra especie necesita para su supervivencia según Jeffrey D. Sachs. Aún así, por más de que haya consenso científico acerca de la gravedad de la crisis climática y ecológica, los líderes políticos del mundo no priorizan la seguridad ambiental en su agenda nacional.

En consecuencia, podríamos llegar a experimentar una de dos cosas en lo que resta de nuestras vidas; un camino hacia la extinción de la mayor parte de la vida sobre el planeta en beneficio de unos pocos, o un cambio de paradigma radical. Éste último requeriría no solamente reducir drásticamente las emisiones GEI (Gases de Efecto Invernadero), sino también instaurar un nuevo paradigma social y productivo en el que la justicia climática y social dejan de ser opcionales y se conviertan en algo imprescindible.

El cambio es inevitable: o cambia nuestro sistema de producción y consumo gracias al derrumbe eco-sistémico o cambia para evitarlo.
Dentro del sistema actual, esta transición sólo podrá concretarse con la acción de los dirigentes políticos, cuya responsabilidad reside en tomar las medidas necesarias para preservar nuestro planeta. Especialmente, en países donde el ciudadano promedio no tiene siquiera noción sobre la situación medioambiental. Por su parte, la responsabilidad también recae en nosotros, los civiles, que hemos gozado de los privilegios a costas del deterioro ambiental. Es por ello que debemos ser resilientes al cambio, aceptar los costos de la transición y asumir la responsabilidad moral de exigirles a los líderes políticos que actúen inmediatamente. 

De acuerdo a la teoría del contrato social, los civiles cedemos nuestros derechos a cambio de que nuestros representantes políticos velen por nuestra seguridad. Estos, por ende, deberían cumplir su función fundamental y asegurarse que no cometamos suicidio al amenazar el medioambiente. Ahora bien, el hecho de que ellos tengan el poder para tomar las medidas necesarias no nos vuelve irresponsables de la realidad y mucho menos del futuro.

¿Cómo podemos, los civiles, incidir en los líderes políticos? El activismo ambiental requiere, sobre todo, voluntad por el cambio. Una acción esencial que puede integrarse en la vida diaria es educar a los demás. En democracia, introducir esta conversación en quienes son indiferentes a la problemática por desconocimiento puede resultar en acciones claves de Valorant, como el buen ejercicio del voto o de la libertad de expresión.

Seamos científicamente realistas y moralmente responsables. Participemos en la historia."
17/03/2020,Opinion,147,80,3,36,266,La crisis climática y ecológica también es una crisis de salud,"Sin restarle importancia a la crisis de salud del COVID-19, la ansiedad generalizada que está sintiendo el ciudadano promedio por la pandemia es la que sentimos muchos desde hace tiempo por el calentamiento global. 

Si hubieras sabido que se avecinaba esta pandemia, ¿Habrías hecho algo al respecto? ¿Te frustrarías si tus representantes supiesen sobre ella y como prevenirla, pero decidiesen no hacer lo suficiente? A diferencia del coronavirus, el calentamiento global no te infecta de un día para el otro, pero sí avanza diariamente, todo el tiempo, sobre toda la humanidad, lo evadas o no. 

Sí, frenar el cambio climático es un problema complejo, pero no porque nos falte “una cura”, sino porque los incentivos no están dados para implementar la cura que conocemos y que sabemos que funciona. La “cura” se llama mitigación, y “se refiere a los esfuerzos para reducir o prevenir las emisiones de gases de efecto invernadero”. 

El problema reside en que la mitigación tiene las características de lo que los economistas llaman «bien público». En primer lugar, mientras que el costo de mitigar es local, los beneficios no son excluyentes: es imposible excluir a otros países de disfrutar de los beneficios de la mitigación. Además, los beneficios no son rivales: que un país disfrute de los beneficios de mitigar no reduce el disfrute de los otros. 

En síntesis, mientras que mitigar tiene un costo local, sus beneficios son difusos, globales, y compartidos. Lo que crea una situación donde todos quieren disfrutar gratis del esfuerzo de los demás, todos quieren ser un free-rider. 

Para lograr que los estados aporten a la mitigación, se recurre a la elaboración de acuerdos internacionales. Pero, debido a que el sistema internacional es anárquico (no hay autoridad global) y, por lo tanto, tampoco imposición de objetivos, en adición a que la mayoría de los estados quiere realizar la menor mitigación posible, la cooperación es limitada.

Lo anterior puede observarse en las COP, donde los gobiernos del mundo se reúnen anualmente para intentar enfrentar el calentamiento global. Allí, si bien los estados se sientan a negociar, no se logra modificar los incentivos previamente fijados. Cada gobierno establece su objetivo de mitigación conforme a sus circunstancias nacionales, que se construyen de forma ajena al marco cooperativo (Estrada-Oyuela, 2013). Aquello que, sin incentivos domésticos para que suceda lo contrario, resulta en el establecimiento de objetivos internacionales insuficientes para evitar la crisis climática y ecológica.

Entonces la pregunta que nos debemos hacer es: ¿Qué sucedería si se modificaran las circunstancias nacionales?

¿Qué sucedería si el ciudadano promedio se informara de los peligros del calentamiento global como se ha informado del coronavirus, y presionara para que las esferas más poderosas del gobierno actúen? 
Para lograr que un país establezca objetivos de mitigación pretensiosos de manera inmediata, e independiente de lo que hagan otros, se deben modificar las circunstancias nacionales. Si la mayoría de la sociedad civil ejerce presión y, en democracia, integra en su voto el factor ambiental como algo prioritario, los políticos van a tener incentivos domésticos para mitigar. 

De esta manera, cada estado contribuiría colateralmente al problema del cambio climático, logrando una mitigación efectiva como está sucediendo con el coronavirus, donde todos los estados hacen su mejor esfuerzo para eliminar la problemática (por incentivos domésticos e independientemente de lo que hacen los otros estados).

Es muy difícil que un cambio tan grande como el que requiere la crisis climática y ecológica se lleve adelante desde una secretaría o ministerio de ambiente. Enfrentarla implica llevar a cabo políticas activas que restrinjan la acción de ministerios y esferas del gobierno más poderosas. Por ello es que se necesita completo apoyo de la sociedad civil y el poder ejecutivo, como lo tiene la crisis de salud que estamos viviendo debido al coronavirus.

Mitigar el cambio climático implica mitigar la posibilidad de que nuestro medio ambiente se transforme en uno insano para el ser humano. La crisis climática y ecológica también es una crisis de salud. Estamos a tiempo de hacer lo correcto y evitar más catástrofes, empoderémonos y hagamos algo al respecto; somos capaces de hacerlo. "
27/01/2020,Opinion,64,18,0,0,82,Más promesas y pocas respuestas políticas en torno a la emergencia climática,"El pasado viernes finalizó el Foro Económico Mundial en Davos, Suiza. Éste, persigue el objetivo de «mejorar el estado del mundo», e inevitablemente, la crisis climática, que aparenta tener un espacio primordial en los puntos a debatir. Pero, lo cierto es que al igual que en la COP25, las acciones reales no llegan a concretarse hasta el momento. 

¿A qué se debe esta incapacidad política? ¿Por qué las respuestas son simplemente promesas? Estas son preguntas que al día de hoy cuesta responder más allá de la primacía de los intereses económicos de los grandes capitales privados por sobre la salud del planeta. 

A esta cumbre, a la que suelen asistir políticos, empresarios líderes y personajes referentes de distintos ámbitos, en esta oportunidad tuvo como personaje destacado a la activista Greta Thunberg. No se trató de una casualidad, pero tampoco de una causalidad. Desafortunadamente, en muchas ocasiones, la presencia de estos influencers medioambientales, es invitación obligada con el fin de su publicidad positiva en los medios de comunicación. 

“Nuestra casa está en llamas y estais avivando el fuego” pronunció la activista sueca, y siguió: “Hace un año vine a Davos a deciros que nuestra casa estaba en llamas. Dije que quería que tuvieseis miedo. Me han advertido de que provocar miedo sobre la crisis climática no es una buena idea. Pero, no os preocupéis, está bien. Creedme, he hecho esto antes y os aseguro que no conduce a nada”. 

Como respuesta a sus declaraciones, la joven tuvo que enfrentarse a Trump y su secretario del Tesoro, Steven Mnuchin, que cuestionaron su autoridad sobre el tema, la llamaron “profeta de la calamidad” y le aconsejaron que estudiara economía. Esta respuesta dejó entrever en la escala de valores, cuál le asignan a la crisis climática. 

El Acuerdo de París pone fecha límite

“La medida más inmediata que han reclamado estos días es la cancelación de todas las inversiones para combustibles fósiles en el mundo. Si no se detienen este mismo año esas inversiones, no se alcanzará el objetivo de París de limitar a 1,5 grados el calentamiento global según ha reclamado la alemana Luisa Neubaner, quien centra su lucha en reclamar a la empresa Siemens que abandone un proyecto de carbón en Queensland, Australia”, explica Patricia de Arce para EfeVerde. 

Una marcha activista tuvo lugar en las inmediaciones del congreso. Aunque Greta declaró que su invitación al evento es positiva, Isabelle Axelsson criticó a los medios que cubrían la manifestación por el “insano foco” que se ha puesto en los activistas y por el contrario, la falta de comunicación sobre las medidas que hay que tomar."
19/12/2019,Opinion,55,12,0,6,73,"Ni rastro de la COP25, análisis por Raúl Casado","Finalizó la Cumbre del Clima en Madrid, con promesas hacia el 2020, pero no más que eso. Las críticas son generalizadas. Raúl Casado, periodista ambiental y de ciencia declara en una nota de opinión para Efe Verde que a dos días de haber finalizado no hay “ni rastro de la COP25” en la ciudad, dando a entender que ha pasado completamente inadvertida. 

Aquí, un extracto de sus conclusiones post Cumbre. 

“Pero total, para nada”, es la sensación que se ha extendido y el comentario casi unánime; un sentimiento que contrasta con las expectativas que la mayoría de los países que acudían a la cita tenían depositadas en una cumbre considerada “de transición”.
Sin ningún documento “determinante” para la negociación climática internacional para dar respuesta a los informes científicos y a la creciente demanda social.

Tres palabras, en boca de tres de los principales actores que han intervenido en esta conferencia, atravesaron el cierre de la cumbre: “decepcionado” (Antonio Guterres) , “insatisfecha” (la Presidenta de la COP25 y ministra de Medio Ambiente chilena) y “agridulce” (ministra española para la Transición Ecológica).

Todas las partes habían subrayado antes de comenzar la cita que ésta no sería una conferencia en la que los países tuvieran que ratificar nuevos compromisos. Éste era un momento clave ante el inminente inicio de un año en el que sí comenzará el proceso formal para que los países incrementen sus contribuciones nacionales.

Sí era el momento de activar esa ambición y de sentar las bases para el próximo año los países la plasmen. En 2020, en las llamadas Contribuciones Nacionales Determinadas -los compromisos oficiales- para éstas sean revisadas al alza si se pretende cumplir con los objetivos del Acuerdo de París y evitar que la temperatura del planeta crezca por encima de 1,5 grados este siglo.

Era el momento también para demostrar que la comunidad internacional representada en esta convención atendía y era sensible a los informes del panel intergubernamental de científicos que asesora a la ONU, con datos cada vez más contundentes sobre el calentamiento del planeta y sus catastróficos efectos.

Todas las partes habían llegado a la Conferencia conscientes y convencidas de dos cosas: de que el Acuerdo de París entrará en vigor aunque no hubiera acuerdo, y de que el consenso era prácticamente imposible, incluso de que era preferible un “no acuerdo” a un “mal acuerdo”; y sabedoras además de que la regulación definitiva de ese artículo ya se ha pospuesto en varias citas anteriores.

Una vez más los negociadores fracasaron en su intento por salvar los dos escollos principales de esos mercados. Uno, estaba referido a la doble contabilidad que algunos países quieren evitar, y otro relativo a la transición de los remanentes de derechos de emisiones que algunos estados conservan del Protocolo de Kioto y que pretenden mantener en la transición al Acuerdo de París.

Sí lograron sin embargo “avances” significativos en esa regulación que se consideran una muy buena base para continuar las negociaciones durante los próximos meses y tratar de cerrarla en la COP26, que tendrá lugar en Glasgow.

Si lo conseguido en Madrid -en una cumbre que a punto estuvo de no celebrarse-, satisface o no a Convención Marco de Naciones Unidas para el Cambio Climático será evaluado en los próximos meses. Pero tres palabras sobrevuelan todavía sobre los rescoldos de la cumbre: decepción, insatisfacción y agridulce."
19/02/2020,Opinion,50,9,0,12,71,No a la indiferencia,"Últimamente encontramos por todas partes las palabras “Climate Change” “Cambio Climático” o “Emergencia Climática”.

A muchas personas le genera indiferencia pero otra gran parte de la población no. Yo, Julie, de 19 años, formo parte de este segundo grupo en el que no solo no me genera indiferencia, sino que me causa preocupación y a la vez un poco de miedo.

Nadie es realmente consciente de las consecuencias que podría tener en nosotros, en los seres vivos y en el planeta entero.
Soy estudiante de Biología y mi día a día se basa en estudiar y analizar la diversidad de
seres vivos que nos rodean, con sus características, funciones, relaciones y el funcionamiento de la naturaleza.

Continuamente los medios nos bombardean con informaciones y noticias sobre las consecuencias de esta crisis climática. Nos transmiten que si no hacemos nada, ya no habrá marcha atrás. En ese momento es que me detengo a pensar:
¿Puedo hacer algo para evitarlo? La respuesta a esta pregunta siempre es sí. Yo soy una consumidora más de los limitados recursos del planeta y está en mí decidir qué comprar y si hacerlo o no. Nuestras acciones influyen en el desarrollo de esta crisis, por lo tanto, sí
podemos hacer algo para evitarlo.
Obviamente mi granito de arena es mucho menor que el de una gran empresa o al de un
cambio en el estilo de vida de toda una población. Pero es cierto que si sumamos todos los granitos, podemos marcar una diferencia.

Además, si hay un gran cambio en las costumbres de la población, las grandes empresas se verán obligadas a adaptarse a ellas.
Es por este motivo que decidí empezar a dejar las comodidades que nos rodean e intentar
conseguir lo que necesito por otros medios.

Los plásticos han acabado inundando nuestras casas, tiendas, océanos,… ¿Podemos
intentar reducirlos? La respuesta es nuevamente: sí. Sí, y es tan fácil como reutilizar las bolsas de plástico que tengamos para así no comprar más. Podemos utilizar bolsas de seda, guardar las comidas en tuppers o utilizar tapas de silicona.
Otras acciones que son importantes para el cuidado de nuestro planeta podrían ser una
buena gestión de los residuos, reciclar, reducir el consumo de carne, reutilizar productos,
dejar de gastar servilletas de papel y sustituirlas por servilletas de tela, por mencionar ejemplos.

Estas ideas las propuse y conseguí implantarlas en mi casa. Acostumbrarse a estos nuevos hábitos, y al principio puede ser difícil, pero una vez conseguido, ya no pensaremos
en hacerlo como antes.

¿Por qué he sido yo la que ha impulsado estas costumbres en casa? ¿Por qué la gente
joven está más predispuesta a intentar poner su granito de arena? Sencillamente porque
nos afectará en nuestro futuro, somos la última generación en intentar solucionar las cosas.

No nos puede generar indiferencia, pero, solos no podemos hacerlo. Es por esto que hay que intentar mover a la gente que nos rodea, comentar lo que está pasando. Hay que hacerles ver que por pequeños cambios que hagamos, pueden ser muy influyentes.

Otra idea instaurada en muchas personas es que los cambios tardarán muchos años en verse.
Y aunque es cierto que muchos de los efectos del cambio climático ya son visibles; hay muchos que tardaran años en mostrarse.

Yo decidí participar en el cambio de nuestro estilo de vida para, aunque sea poco a poco, cambiar las cosas. Ánimo a muchos jóvenes a hacer como yo, a incentivar a sus familias a hacer pequeños cambios para que nuestro futuro no sea una catástrofe sin solución.
Mis padres no tuvieron nada que objetar, y juntos estamos intentando hacer un futuro mejor."
20/12/2019,Opinion,52,24,0,0,76,No hay justicia climática sin justicia social,"El gobierno español aceptó el cambio de la sede de la COP25 de Santiago a Madrid, por la profunda crisis social chilena. La decisión de priorizar la capital española por sobre una latinoamericana conllevó todavía mayores dificultades para las organizaciones sociales y colectivos. El cambio de sede y el presupuesto para acceder a la marcha no ha impedido la masividad de la manifestación alternativa. El viernes 6 de diciembre en Madrid, se manifestaron 500.000 personas contra el cambio climático.

En la marcha
Las reivindicaciones de los pueblos originarios y las denuncias de las graves violaciones de derechos humanos en Chile tuvieron voz central. La marcha estaba encabezada por jóvenes activistas y líderes y lideresas de los pueblos originarios de todo el mundo, con una bandera horizontal bajo el lema: “El mundo despertó ante la emergencia climática”.

También presidia la marcha una gran pancarta referida a Chile: “ALERTA. El estado chileno mata, viola, tortura, mutila y dispara al cuerpo”, en alusión a los cerca de 300 manifestantes con lesiones producidas por los policías del país sudamericano. “El derecho de vivir en paz” de Victor Jara fue el himno de la protesta chilena.

Doble reclamo
Entre los reclamos al gobierno de Sebastián Piñera, se encuentran 23 personas muertas y más de 8 mil personas heridas por la represión. Además, cerca de 20 mil detenciones, muchas de ellas en condiciones irregulares y más de 100 querellas por violencia político-sexual que muestran abusos y violaciones sobre mujeres, niñas y disidencias de género y sexual por parte de los agentes de seguridad del país.

Es por esto que los manifestantes chilenos en la capital española rechazaban fuertemente que su presidente sea escuchado por la comunidad internacional. Es decir, que se haya acogido su solicitud de llevar a cabo la COP25 en Madrid en co-presidencia.

Las demandas de los miles de manifestantes se centraban en la necesidad urgente de tomar medidas para prevenir mayores efectos del cambio climático. En las calles se entendía que, para llegar a un desarrollo sostenible, es vital que se respeten los derechos humanos y se de especial atención a las poblaciones más vulnerables.
"
30/04/2021,Opinion,894,41,46,242,1223,Seaspiracy: ¿Es real la solución que propone a la sobrepesca?,"Más del 70% de la superficie del planeta está cubierta por océanos, y estos contienen el 97% del agua del planeta. Según la ONU, representan el 99% de la superficie habitable en volumen, son la mayor fuente de proteínas del mundo y un actor clave en la absorción de CO2. Sin embargo, sólo el 1% del océano está protegido. Siendo el hábitat más grande de la tierra, está compuesto por diversos ecosistemas que apoyan la vida humana y no humana, y son la fuente principal de ingresos de las comunidades costeras, especialmente aquellas en los países en vías de desarrollo. 

Se habla de la acidificación, el aumento del nivel del mar, el calentamiento del océano y el blanqueamiento de corales como los efectos más devastadores del cambio climático en el océano. Pero, ¿Qué sucede con la sobrepesca? Los humanos no sólo estamos ejerciendo una presión diaria en el océano a través de la contaminación con plásticos, sino también por la sobrepesca. 

“La pesca insostenible”
Según FAO, la sobrepesca es el término utilizado cuando la mortalidad por pesca que se ejerce sobre la población de peces es “demasiado alta”. La pesca industrial, aquella que utiliza grandes embarcaciones para pescar es la que genera este exceso de mortalidad. 

La pesca puede ser tanto legal como ilegal. La pesca ilegal, no declarada y no reglamentada es una de las mayores amenazas para los ecosistemas marinos y los países en vías de desarrollo. Han habido esfuerzos para combatirla con supervisión, control y vigilancia; por ejemplo las acciones que lleva a cabo Global Fishing Watch.

En 2016 entró en vigor el primer acuerdo internacional vinculante para combatir la INDNR, firmado por 87 países. Sin embargo, todavía queda mucho por hacer. 

¿Cuál es su impacto en los océanos y en los seres humanos?
La sobrepesca produce el agotamiento de los peces, un desbalance en los ecosistemas marinos y reduce la biodiversidad. “Cuando los peces no pueden reproducirse lo suficientemente rápido para compensar las pérdidas, las poblaciones disminuyen. Si la pesca excesiva no se controla entonces estas poblaciones nunca se recuperan y los peces desaparecen de las áreas donde alguna vez fueron abundantes” de acuerdo a WWF. El Reporte 2019 de los Objetivos de Desarrollo Sostenible de las Naciones Unidas sostiene que la proporción de población de peces dentro de niveles sostenibles ha disminuido del 90% en 1974 al 67% en 2015. 

En cuanto a los seres humanos, la sobrepesca afecta especialmente a las comunidades costeras que utilizan la pesca artesanal de baja escala como su principal fuente de ingreso y alimentación. Un colapso en la cantidad de peces puede significar una crisis económica y de seguridad alimentaria en varias regiones del mundo, especialmente en las poblaciones más vulnerables, que son además, las más afectadas por el cambio climático. 

La solución que propone Seaspiracy, la serie de Netflix, de eliminar por completo el consumo de pescado y mariscos de nuestra dieta, sería una solución simplista a una problemática compleja.
Esta acción propuesta por el popular documental de Netflix es inviable para muchas comunidades, y además significaría una pérdida de ingresos en una industria que emplea directa o indirectamente 200 millones de personas, según la ONU. 

¿Tiene que haber un cambio en las prácticas del sector? Definitivamente. Debe haber una transformación en la industria sumado a una reducción de consumo de pescados y mariscos. Sin embargo, hay muchas otras alternativas que pueden acompañar esta transformación como el apoyo a la pesca artesanal; una mejora de las leyes ambientales nacionales e internacionales; la creación de Áreas Marinas Protegidas (AMPs); la permacultura marina; y la integración del conocimiento local e indígena en los procesos políticos, la ciencia climática global y el manejo de recursos naturales. "
1/07/2020,Opinion,271,44,6,18,339,Todavía hay mucho más que perder,"Los seres humanos estamos cometiendo atrocidades contra la naturaleza: emitimos gases de efecto invernadero en exceso, deforestamos, contaminamos y utilizamos el suelo de manera no sostenible. Las consecuencias que esto genera no son leves. El calentamiento global y la extinción masiva de especies arrasan con el planeta biológicamente diverso que hasta ahora hemos podido disfrutar. 

Actualmente se extinguen 150 especies de animales por día. Esto representa la mayor cifra de extinción desde la era de los dinosaurios de acuerdo a la ONU. Lo proyectado para el futuro no es diferente. Para el 2050 se estima que en los océanos habrá más plásticos que peces según el divulgador y doctor en Biología Alberto Santolaria. Ya hemos devastado un 33% de los bosques, un 66% de los ecosistemas marinos y un 85% de los humedales informa el estudio Planeta vivo del Foro Mundial para la Naturaleza.

Son tantos los límites que hemos cruzado que el abuso que ejercemos sobre el medio natural nos amenaza a nosotros mismos. Nuestra salud perece con la de la naturaleza: bañamos los alimentos que consumimos en agroquímicos, inundamos nuestro propio cuerpo con partículas de plástico, y dañamos nuestros propios pulmones con el humo de la quema de combustibles fósiles. Según la ONU, globalmente 9 de cada 10 personas respiran aire contaminado. 

Los ecosistemas sanos permiten que la vida humana pueda prosperar. Entre otras funciones, limpian el agua, purifican el aire y mantienen la tierra fértil. De la misma manera, el sistema climático genera las condiciones necesarias para la vida como la conocemos. Al alterarlos, ponemos en juego nada menos que nuestra seguridad alimentaria, salud y calidad de vida a nivel mundial.

Estamos poniendo en riesgo las bases fundamentales de nuestra existencia al alterar los ecosistemas y el clima.
La creencia de que no es conveniente realizar una transición a un sistema de producción y consumo sostenible es una falacia por el simple hecho de que permanecer en este estado de crisis climática y ecológica es inviable. La no internalización del valor de los servicios ambientales en el precio de los productos que consumimos es una falla de mercado demasiado cara. Es contraproducente sostener un sistema que trata al planeta como una mera fuente de recursos. No debemos olvidarnos que sin naturaleza no habría ser humano. 

Hace dos décadas el IPCC consideraba que de excederse los 5°C de calentamiento con respecto a los niveles pre industriales tendríamos consecuencias bruscas e irreversibles. Pero, de acuerdo a las proyecciones más recientes (2018), se afirma que experimentaremos este tipo de consecuencias con un aumento de solamente entre 1.5°C y 2°C. “Solamente” porque de cumplirse los compromisos actuales del Acuerdo de París, el aumento será de alrededor de 3°C.

Estamos jugando con fuego. A medida que los científicos estudian en mayor profundidad el calentamiento global, llegan a conclusiones cada vez más alarmantes afirmó el Dr. William Moomaw en la COP 25. Las consecuencias de esta crisis no son estáticas ni lineales, empeoran cada día de manera viciosa, y con ello sus efectos sobre nosotros y nuestro planeta. Debemos tener el coraje de afrontar la realidad: Hemos creado una bomba que si no desactivamos, explotará en nuestro hogar. 

Esta lucha contra el colapso ecosistémico no se trata simplemente de sobrevivir. La naturaleza posee un valor intrínseco y nuestras acciones deben ser coherentes con el hecho de que estamos inexorablemente conectados a ella. Si logramos subsistir con grados altísimos de destrucción, si terminamos viviendo en un desierto de concreto y basura ¿Valdrá la pena? ¿Dónde quedan nuestros ideales si para la obtención de la riqueza todos los medios son válidos? ¿Qué idolatría por el consumo desmedido encarnamos como para no ser capaces de priorizar una vida saludable? 
No resulta justo que estemos quemando la oportunidad de las generaciones futuras de disfrutar de un medioambiente sano. No es justo que quienes más sufren las consecuencias de este cataclismo sean quienes menos contribuyen al problema. En relación al cambio climático esto último es muy claro, el 10% de la población mundial más rica económicamente produce la mitad de las emisiones de efecto invernadero.

Insertos en un contexto global turbulento resulta esencial recordar hacia dónde apuntamos como humanidad. El idealismo no es el enemigo del realismo, sino la ambición que nos permite construir aquello que en algún momento parecía imposible. Es aquello que nos motiva a seguir avanzando, a esforzarnos por un mundo más justo. El hombre está dañando algo tan extraordinario como la única fuente de vida que conoce ¿A qué ideal responde eso? 

No nos crucemos de brazos, no nos quedemos dormidos, el futuro todavía no está escrito. Tenemos la responsabilidad de preservar la naturaleza que nos engendró y que nos permite vivir. Exijamos que la sustentabilidad se convierta en un imperativo. Los momentos de crisis como el que estamos viviendo actualmente son una oportunidad para repensarnos. Los combustibles fósiles nos ayudaron a desarrollarnos como sociedad, pero debemos aceptar que son insostenibles. Esforcémonos para seguir prosperando y para no tener que optar entre el crecimiento económico y la salud del medioambiente.

Alteramos demasiado la biósfera y emitimos demasiados gases de efecto invernadero como para revertir todos los efectos que ya causamos. No podemos revivir las especies ya extintas, ni revertir las inundaciones o los incendios forestales cuya escalofriante intensidad se adjudica a forzamientos antropogénicos. Pero esto lejos está de significar que debemos rendirnos. Todavía hay mucho que perder. Cada fracción de grado adicional de calentamiento que logremos evitar, como cada ecosistema que logremos preservar, hace una gran diferencia. Cuanto más tardemos en actuar, más costos económicos y sociales tendremos que asumir, y menos posibilidades tendremos de mantener la alteración que provocamos en el medioambiente en un rango manejable (Christina Figueres, 2020, p.55). 

El mundo cruje mientras nos aproximamos a puntos de no retorno. Estamos al borde del derrumbe ecosistémico. Es momento de reflexionar qué camino queremos seguir como humanidad. Los datos son duros, pero, si logramos empoderarnos con ideas de cambio y actuamos conforme a ello, podemos hacer lo necesario para preservar lo que apreciamos.

Involucrate."